Downsample[ns],BuildFilTree[ns],SearchFil[ns],DeleteFil[ns],BuildTreeSub[ns],SearchSub[ns],DeleteSub[ns],PreProcTotal[ns],Plane[ns],Total[ns],nx,ny,nz
7765,0,0,0,0,8531,190,16486,2091,18577,0.0140291,-0.0500655,-0.998647
4500,0,0,0,0,4457,118,9075,1806,10881,0.0299216,-0.0842919,-0.995992
2475,0,0,0,0,3431,88,5994,1406,7400,0.00450454,-0.0444973,-0.998999
2718,0,0,0,0,3411,96,6225,1480,7705,-0.0389256,-0.0457475,-0.998194
2697,0,0,0,0,3543,94,6334,1314,7648,-0.046374,-0.046827,-0.997826
3535,0,0,0,0,4347,104,7986,1951,9937,-0.0487464,-0.0416479,-0.997943
2496,0,0,0,0,3926,108,6530,1590,8120,-0.073345,-0.0258095,-0.996973
2720,0,0,0,0,3416,113,6249,1481,7730,-0.0377862,-0.0171741,-0.999138
2667,0,0,0,0,3175,101,5943,1225,7168,-0.0504048,0.00103626,-0.998728
3596,0,0,0,0,4397,97,8090,1712,9802,-0.00752226,-0.024907,-0.999661
3874,0,0,0,0,2888,78,6840,1216,8056,-0.0129097,-0.0349032,-0.999307
2632,0,0,0,0,2817,87,5536,1386,6922,0.0125655,-0.0774389,-0.996918
2497,0,0,0,0,3215,86,5798,1352,7150,0.00429754,-0.10074,-0.994904
3515,0,0,0,0,4199,122,7836,1761,9597,0.00339986,-0.0373391,-0.999297
3322,0,0,0,0,4255,110,7687,2055,9742,-0.00202813,-0.0733458,-0.997305
6933,0,0,0,0,7917,170,15020,2018,17038,-0.000235505,-0.0419745,-0.999119
7166,0,0,0,0,10768,200,18134,3052,21186,0.0152482,-0.0146361,-0.999777
1753,0,0,0,0,2249,57,4059,1209,5268,0.0190201,0.0626408,-0.997855
1732,0,0,0,0,2294,104,4130,934,5064,-0.00652588,0.0155695,-0.999857
1955,0,0,0,0,2367,75,4397,964,5361,-0.0269634,0.0199145,-0.999438
2244,0,0,0,0,2245,63,4552,1067,5619,-0.0691515,0.0207017,-0.997391
1930,0,0,0,0,2374,74,4378,889,5267,-0.065676,0.0116467,-0.997773
2099,0,0,0,0,2257,83,4439,884,5323,-0.0569394,0.0039772,-0.99837
1750,0,0,0,0,2429,65,4244,768,5012,-0.0703293,-0.0182778,-0.997356
1514,0,0,0,0,2242,69,3825,855,4680,-0.0860484,-0.0138965,-0.996194
1989,0,0,0,0,2633,70,4692,912,5604,-0.0856262,0.0109613,-0.996267
1684,0,0,0,0,2444,75,4203,1023,5226,-0.0564991,0.0231649,-0.998134
2654,0,0,0,0,2236,69,4959,935,5894,-0.0173996,-0.0467808,-0.998754
1786,0,0,0,0,2178,119,4083,888,4971,-0.0185585,-0.0288662,-0.999411
2244,0,0,0,0,2130,54,4428,1033,5461,-0.0485214,-0.0153238,-0.998705
2254,0,0,0,0,2171,72,4497,928,5425,-0.0218583,-0.0404381,-0.998943
1571,0,0,0,0,2078,60,3709,907,4616,-0.0367272,-0.0629209,-0.997343
1694,0,0,0,0,2434,112,4240,785,5025,-0.0285716,-0.0615651,-0.997694
2427,0,0,0,0,2257,68,4752,1116,5868,-0.0741635,-0.0942048,-0.992787
1520,0,0,0,0,2474,83,4077,1028,5105,-0.00835976,-0.0369227,-0.999283
1807,0,0,0,0,2250,70,4127,1096,5223,-0.00951527,-0.0476602,-0.998818
1554,0,0,0,0,2073,55,3682,976,4658,-0.00258871,-0.0314272,-0.999503
1557,0,0,0,0,1998,87,3642,992,4634,-0.0214336,-0.0153831,-0.999652
1463,0,0,0,0,1982,115,3560,1315,4875,-0.0725406,0.0331955,-0.996813
1577,0,0,0,0,1958,50,3585,814,4399,-0.0851287,-0.0158527,-0.996244
1574,0,0,0,0,2013,57,3644,853,4497,-0.0747581,0.0115917,-0.997134
1596,0,0,0,0,1977,74,3647,1013,4660,-0.0567709,-0.000532863,-0.998387
1534,0,0,0,0,2106,58,3698,728,4426,-0.0478944,0.0403671,-0.998036
1450,0,0,0,0,2462,110,4022,863,4885,-0.0654233,-0.00722036,-0.997831
1550,0,0,0,0,2037,57,3644,1020,4664,-0.0347624,-0.015751,-0.999271
1675,0,0,0,0,2240,62,3977,918,4895,-0.0351813,-0.0164913,-0.999245
5162,0,0,0,0,6876,200,12238,2744,14982,-0.0386888,-0.00563322,-0.999235
6808,0,0,0,0,7292,185,14285,1738,16023,-0.03996,0.00251347,-0.999198
2365,0,0,0,0,3122,84,5571,1345,6916,-0.0342412,-0.00732766,-0.999387
6559,0,0,0,0,8808,199,15566,2049,17615,-0.0767456,-0.01847,-0.99688
4274,0,0,0,0,4735,148,9157,1935,11092,-0.0444573,0.030157,-0.998556
3627,0,0,0,0,4510,118,8255,2041,10296,-0.0610195,-0.00837919,-0.998101
5086,0,0,0,0,5626,158,10870,2271,13141,-0.0426811,0.0289921,-0.998668
4107,0,0,0,0,6492,178,10777,2142,12919,-0.0459326,0.0345749,-0.998346
2904,0,0,0,0,4099,116,7119,1870,8989,-0.0756983,-0.0194604,-0.996941
3735,0,0,0,0,4336,108,8179,1571,9750,-0.00932535,-0.0328875,-0.999416
2213,0,0,0,0,2553,76,4842,1028,5870,-0.00556794,-0.0460593,-0.998923
3122,0,0,0,0,4378,98,7598,1508,9106,-0.0323056,-0.0616112,-0.997577
3803,0,0,0,0,4653,136,8592,2143,10735,-0.0421226,-0.0762876,-0.996196
6812,0,0,0,0,8972,291,16075,3753,19828,-0.0776676,-0.0979417,-0.992157
8851,0,0,0,0,9173,197,18221,2073,20294,0.00261657,-0.0389175,-0.999239
2979,0,0,0,0,3004,76,6059,1316,7375,0.00566468,-0.00966706,-0.999937
2368,0,0,0,0,3016,89,5473,1378,6851,-0.0156527,0.00252052,-0.999874
3086,0,0,0,0,3658,97,6841,1575,8416,-0.0428632,0.01587,-0.998955
3076,0,0,0,0,3819,104,6999,1474,8473,-0.0763408,0.0261527,-0.996739
3539,0,0,0,0,4068,106,7713,2388,10101,-0.0514972,0.00273546,-0.998669
7550,0,0,0,0,10599,161,18310,2485,20795,-0.0475127,-0.00713099,-0.998845
2883,0,0,0,0,3087,81,6051,1261,7312,-0.0469635,-0.00920193,-0.998854
2009,0,0,0,0,2234,62,4305,971,5276,-0.0536953,-0.00935299,-0.998514
6582,0,0,0,0,5409,124,12115,1554,13669,-0.0402932,-0.00599019,-0.99917
2669,0,0,0,0,2968,79,5716,1254,6970,-0.0544757,0.0445802,-0.997519
3399,0,0,0,0,4033,111,7543,2007,9550,-0.00688249,0.0754042,-0.997129
6500,0,0,0,0,7960,219,14679,2162,16841,-0.00376876,0.0738428,-0.997263
6476,0,0,0,0,5229,105,11810,2049,13859,-0.0162207,0.103996,-0.994445
2260,0,0,0,0,2688,75,5023,1331,6354,-0.0154242,0.0924363,-0.995599
6585,0,0,0,0,7517,217,14319,2517,16836,-0.0435467,0.0497553,-0.997812
2663,0,0,0,0,2820,68,5551,1352,6903,-0.0245177,0.0571646,-0.998064
1683,0,0,0,0,1851,47,3581,1052,4633,-0.00950061,-0.0176148,-0.9998
2033,0,0,0,0,2183,56,4272,1100,5372,-0.0250377,0.0199625,-0.999487
6198,0,0,0,0,6857,192,13247,3232,16479,-0.0375155,0.0362321,-0.998639
4559,0,0,0,0,4202,98,8859,1756,10615,-0.0410155,0.0286142,-0.998749
6033,0,0,0,0,6202,197,12432,2199,14631,-0.0735979,0.0690381,-0.994896
2761,0,0,0,0,2713,75,5549,1661,7210,-0.082285,0.0834321,-0.99311
4508,0,0,0,0,4995,153,9656,3099,12755,-0.0853454,0.0747768,-0.993541
3578,0,0,0,0,3675,100,7353,2125,9478,-0.0031426,-0.0195369,-0.999804
2710,0,0,0,0,2968,77,5755,2116,7871,-0.00363336,-0.0621221,-0.998062
3425,0,0,0,0,3480,91,6996,1870,8866,-0.0102873,-0.0846943,-0.996354
3206,0,0,0,0,4249,121,7576,1859,9435,0.00355654,-0.0403838,-0.999178
3501,0,0,0,0,3476,92,7069,2395,9464,0.0198931,-0.0278787,-0.999413
7290,0,0,0,0,5867,119,13276,2739,16015,0.0370954,-0.0061392,-0.999293
2695,0,0,0,0,2784,73,5552,1710,7262,0.0403517,0.0342063,-0.9986
3445,0,0,0,0,3739,97,7281,2126,9407,0.0612905,0.0324087,-0.997594
5627,0,0,0,0,6173,198,11998,2600,14598,0.0892336,-0.00590403,-0.995993
3035,0,0,0,0,3404,91,6530,1977,8507,0.0787172,-0.0401207,-0.996089
6364,0,0,0,0,6479,137,12980,2395,15375,-0.00485138,-0.0636738,-0.997959
2567,0,0,0,0,2578,73,5218,1684,6902,-0.0244385,-0.11715,-0.992813
5922,0,0,0,0,4897,127,10946,2410,13356,-0.0223666,-0.0239057,-0.999464
3349,0,0,0,0,3525,91,6965,3079,10044,-0.0260387,-0.0242012,-0.999368
4006,0,0,0,0,3372,92,7470,2316,9786,-0.0256381,-0.0455172,-0.998635
6161,0,0,0,0,6971,147,13279,2037,15316,-0.036228,-0.0108026,-0.999285
2696,0,0,0,0,2854,75,5625,1747,7372,-0.0313534,-0.0463764,-0.998432
3048,0,0,0,0,3299,86,6433,2839,9272,-0.0517571,-0.0260993,-0.998319
3798,0,0,0,0,3994,105,7897,2372,10269,-0.0604709,-0.100892,-0.993058
3458,0,0,0,0,3772,100,7330,2038,9368,-0.0705213,-0.132732,-0.98864
3385,0,0,0,0,3855,101,7341,2108,9449,0.0179705,-0.0207961,-0.999622
6529,0,0,0,0,6823,181,13533,3031,16564,0.00551607,-0.0384168,-0.999247
3197,0,0,0,0,3539,91,6827,2032,8859,-0.00968809,-0.0380088,-0.99923
3083,0,0,0,0,3385,91,6559,2261,8820,-0.00573924,-0.0794615,-0.996821
5987,0,0,0,0,8043,205,14235,2277,16512,-0.0308794,-0.126674,-0.991464
3203,0,0,0,0,3408,97,6708,1677,8385,-0.00469039,-0.0617467,-0.998081
2603,0,0,0,0,2860,73,5536,2005,7541,-0.0330126,-0.0961223,-0.994822
4508,0,0,0,0,4826,128,9462,2117,11579,-0.0219325,-0.0553494,-0.998226
2357,0,0,0,0,2608,77,5042,1502,6544,-0.0166809,-0.0716694,-0.997289
4537,0,0,0,0,4981,130,9648,2878,12526,-0.00937374,-0.0484125,-0.998783
6145,0,0,0,0,6647,177,12969,4646,17615,-0.0307886,-0.0683686,-0.997185
3204,0,0,0,0,2911,111,6226,1228,7454,0.00337798,-0.0471859,-0.99888
2072,0,0,0,0,2135,50,4257,1209,5466,-0.0444736,-0.0370379,-0.998324
1493,0,0,0,0,1547,38,3078,905,3983,-0.0484642,-0.0352201,-0.998204
2357,0,0,0,0,3078,72,5507,1385,6892,-0.00207241,-0.0486305,-0.998815
3906,0,0,0,0,4349,114,8369,2442,10811,-0.0256196,-0.0822319,-0.996284
3960,0,0,0,0,4269,123,8352,1957,10309,-0.0045681,-0.0340315,-0.99941
4011,0,0,0,0,4688,122,8821,2829,11650,0.00266078,-0.0219018,-0.999757
3964,0,0,0,0,4220,120,8304,1672,9976,0.00186269,-0.0160079,-0.99987
2718,0,0,0,0,2647,75,5440,1595,7035,0.00327315,-0.0185845,-0.999822
4190,0,0,0,0,4268,112,8570,3046,11616,0.0146461,-0.0540214,-0.998432
4276,0,0,0,0,4241,112,8629,3084,11713,0.0270118,-0.109814,-0.993585
3182,0,0,0,0,3149,92,6423,1881,8304,0.00645746,-0.0607931,-0.99813
3836,0,0,0,0,3677,99,7612,1940,9552,-0.00364272,-0.0557274,-0.998439
4855,0,0,0,0,4385,103,9343,2093,11436,-0.0121893,-0.0533128,-0.998503
4912,0,0,0,0,3531,78,8521,1988,10509,-0.0118804,-0.0573791,-0.998282
2629,0,0,0,0,2407,64,5100,1162,6262,0.00409436,-0.0613214,-0.99811
4067,0,0,0,0,3233,91,7391,3060,10451,0.0141343,-0.0940156,-0.99547
4003,0,0,0,0,2684,84,6771,2370,9141,0.00447489,-0.0649991,-0.997875
4076,0,0,0,0,3535,112,7723,2210,9933,0.00373835,-0.0707716,-0.997486
5989,0,0,0,0,5030,144,11163,2388,13551,0.009053,-0.0676633,-0.997667
3123,0,0,0,0,2527,82,5732,1646,7378,0.018035,-0.0576284,-0.998175
4777,0,0,0,0,3555,110,8442,2916,11358,0.0175165,-0.0394107,-0.99907
3342,0,0,0,0,2323,68,5733,2014,7747,0.0101878,-0.0906768,-0.995828
3280,0,0,0,0,2216,72,5568,1673,7241,0.0246079,-0.0656717,-0.997538
5111,0,0,0,0,3557,120,8788,2420,11208,0.0112198,-0.0906693,-0.995818
3684,0,0,0,0,2474,72,6230,2369,8599,-0.0166761,-0.104074,-0.99443
5957,0,0,0,0,3965,152,10074,2296,12370,0.00930676,-0.0706408,-0.997458
2426,0,0,0,0,1951,60,4437,1559,5996,0.0173383,-0.0674449,-0.997572
5850,0,0,0,0,3892,120,9862,2605,12467,0.0207051,-0.119092,-0.992667
2710,0,0,0,0,1585,53,4348,1324,5672,0.0228808,-0.0924958,-0.99545
1538,0,0,0,0,967,33,2538,751,3289,0.00385126,-0.0984632,-0.995133
1976,0,0,0,0,1124,39,3139,1198,4337,0.000626276,-0.0920116,-0.995758
5815,0,0,0,0,3821,124,9760,3158,12918,0.00691018,-0.1012,-0.994842
3166,0,0,0,0,1923,56,5145,2040,7185,0.0504375,0.00437391,-0.998718
5983,0,0,0,0,3881,119,9983,3067,13050,0.0268251,-0.0582982,-0.997939
3930,0,0,0,0,2672,76,6678,1816,8494,0.0151644,-0.0966546,-0.995202
3732,0,0,0,0,2408,71,6211,2339,8550,0.00822912,-0.0829067,-0.996523
3576,0,0,0,0,2495,76,6147,2029,8176,-0.003911,-0.0558106,-0.998434
4565,0,0,0,0,3084,104,7753,2480,10233,-0.00484123,-0.0626411,-0.998024
4824,0,0,0,0,3233,123,8180,2020,10200,-0.00961126,-0.0319546,-0.999443
5788,0,0,0,0,3974,124,9886,1918,11804,0.00762526,-0.0493619,-0.998752
3075,0,0,0,0,1801,53,4929,1639,6568,0.0253843,0.0176773,-0.999521
5800,0,0,0,0,3065,85,8950,1851,10801,-0.0196762,-0.0613527,-0.997922
2579,0,0,0,0,1908,55,4542,1438,5980,0.00319114,-0.0486917,-0.998809
5942,0,0,0,0,4158,108,10208,2069,12277,-0.0113793,-0.0729007,-0.997274
2547,0,0,0,0,1988,76,4611,1674,6285,0.00316242,-0.0866503,-0.996234
4403,0,0,0,0,3526,108,8037,3252,11289,0.00253455,-0.0992053,-0.995064
6545,0,0,0,0,3684,100,10329,1858,12187,0.0195346,-0.0488485,-0.998615
5847,0,0,0,0,3333,117,9297,1704,11001,0.0250652,-0.0907023,-0.995563
5876,0,0,0,0,3720,89,9685,2186,11871,0.0146704,-0.0443228,-0.99891
2433,0,0,0,0,1867,52,4352,1320,5672,0.0243578,-0.0922531,-0.995438
5856,0,0,0,0,5213,127,11196,2674,13870,0.013565,-0.0634299,-0.997894
2990,0,0,0,0,2327,78,5395,2276,7671,0.00788307,-0.119707,-0.992778
3736,0,0,0,0,2298,71,6105,1901,8006,0.018803,-0.0789526,-0.996701
3147,0,0,0,0,2233,64,5444,2003,7447,0.00137039,-0.0721399,-0.997394
5917,0,0,0,0,4357,129,10403,2611,13014,0.0199649,-0.057003,-0.998174
2454,0,0,0,0,1715,54,4223,1420,5643,0.00358582,-0.0724345,-0.997367
4185,0,0,0,0,3029,86,7300,3161,10461,0.0113359,-0.0689938,-0.997553
5199,0,0,0,0,2885,91,8175,2861,11036,0.0209543,-0.012978,-0.999696
3440,0,0,0,0,2137,65,5642,2430,8072,0.0302191,0.028644,-0.999133
3159,0,0,0,0,2086,59,5304,2202,7506,0.0189835,-0.0631515,-0.997823
5218,0,0,0,0,3463,115,8796,3814,12610,0.0568095,-0.0259891,-0.998047
3655,0,0,0,0,2326,65,6046,1966,8012,0.0410924,0.0427786,-0.998239
6065,0,0,0,0,2802,72,8939,2149,11088,0.0175218,-0.0764848,-0.996917
2376,0,0,0,0,2197,53,4626,1582,6208,0.034956,-0.0971454,-0.994656
5789,0,0,0,0,3735,103,9627,3760,13387,0.0186447,-0.0889088,-0.995865
2977,0,0,0,0,1883,52,4912,1690,6602,0.0225738,-0.0774793,-0.996738
5751,0,0,0,0,3764,117,9632,2248,11880,0.0147198,-0.102665,-0.994607
3012,0,0,0,0,2041,63,5116,2052,7168,0.0223384,-0.0740882,-0.997001
3064,0,0,0,0,2093,58,5215,1770,6985,0.0217205,-0.0738581,-0.997032
3760,0,0,0,0,2615,74,6449,2195,8644,0.0302197,-0.102367,-0.994288
4683,0,0,0,0,3511,97,8291,3508,11799,0.0229284,-0.0735916,-0.997025
3451,0,0,0,0,2572,71,6094,1890,7984,0.0164631,-0.074252,-0.997104
4357,0,0,0,0,3344,91,7792,2237,10029,0.00860643,-0.0657708,-0.997798
5734,0,0,0,0,4545,123,10402,2549,12951,0.0147753,-0.0841254,-0.996346
2866,0,0,0,0,2078,65,5009,1350,6359,0.0116452,-0.0829648,-0.996484
3491,0,0,0,0,2896,78,6465,1881,8346,0.0031202,-0.0917308,-0.995779
6104,0,0,0,0,3822,107,10033,2029,12062,0.0209263,-0.0886867,-0.99584
3271,0,0,0,0,2891,78,6240,1631,7871,0.00578314,-0.0953078,-0.995431
3445,0,0,0,0,2996,83,6524,1786,8310,0.0103725,-0.0925526,-0.995654
6093,0,0,0,0,5693,181,11967,2460,14427,0.0137956,-0.0940885,-0.995468
3242,0,0,0,0,3129,91,6462,1515,7977,0.00932088,-0.0840375,-0.996419
6010,0,0,0,0,6062,177,12249,3034,15283,0.00456235,-0.134234,-0.990939
4200,0,0,0,0,2702,78,6980,1130,8110,0.0168178,-0.133553,-0.990899
1852,0,0,0,0,1718,45,3615,810,4425,-0.000252594,-0.0792819,-0.996852
6253,0,0,0,0,6474,129,12856,1704,14560,0.00891112,-0.0749126,-0.99715
2163,0,0,0,0,2387,72,4622,1093,5715,-0.00339417,-0.0754522,-0.997144
4512,0,0,0,0,4836,137,9485,2224,11709,0.00341341,-0.100373,-0.994944
4606,0,0,0,0,4694,132,9432,2162,11594,0.00205349,-0.0633746,-0.997988
4352,0,0,0,0,4861,143,9356,2088,11444,-0.00895126,-0.0724749,-0.99733
6423,0,0,0,0,7084,197,13704,2090,15794,-0.000576151,-0.11505,-0.99336
2570,0,0,0,0,2835,65,5470,1101,6571,-0.0050673,-0.0805158,-0.99674
1881,0,0,0,0,2013,53,3947,888,4835,-0.00891451,-0.0695066,-0.997542
3938,0,0,0,0,4150,112,8200,2045,10245,-0.00640706,-0.0654198,-0.997837
4887,0,0,0,0,5325,156,10368,1736,12104,-0.00519549,-0.0546032,-0.998495
4037,0,0,0,0,4091,108,8236,1762,9998,-0.00675107,-0.0623466,-0.998032
4402,0,0,0,0,4919,146,9467,2120,11587,-0.0273987,-0.0807872,-0.996355
3400,0,0,0,0,3627,94,7121,1598,8719,-0.000784187,-0.0541453,-0.998533
2537,0,0,0,0,2723,71,5331,1343,6674,-0.0202242,-0.0660144,-0.997614
4411,0,0,0,0,4515,119,9045,2181,11226,-0.00408097,-0.0538775,-0.998539
6990,0,0,0,0,7041,163,14194,2290,16484,-0.0249833,-0.06695,-0.997443
3214,0,0,0,0,2950,79,6243,1794,8037,-0.0174014,-0.0987978,-0.994955
3697,0,0,0,0,3410,89,7196,1900,9096,-0.0357033,-0.155876,-0.987131
6342,0,0,0,0,7184,170,13696,2601,16297,-0.0325508,-0.196007,-0.980062
2659,0,0,0,0,2208,65,4932,1339,6271,-0.00200254,0.00472174,-0.999987
5943,0,0,0,0,5157,153,11253,3499,14752,-0.0185488,-0.126649,-0.991774
2635,0,0,0,0,2062,55,4752,1350,6102,0.0105936,-0.026475,-0.999593
1710,0,0,0,0,1628,46,3384,933,4317,0.00796222,0.000375858,-0.999968
1625,0,0,0,0,1297,36,2958,1137,4095,-0.00132267,0.0119452,-0.999928
5800,0,0,0,0,4358,120,10278,3597,13875,-0.0368355,-0.0838349,-0.995799
3892,0,0,0,0,2662,63,6617,1881,8498,-0.0355027,-0.0611067,-0.9975
5908,0,0,0,0,4235,133,10276,2535,12811,-0.0261205,-0.0557308,-0.998104
2963,0,0,0,0,2135,67,5165,2579,7744,-0.0275118,-0.109815,-0.993571
5717,0,0,0,0,3820,107,9644,2659,12303,-0.0293476,-0.110916,-0.993396
3952,0,0,0,0,2702,81,6735,3063,9798,-0.0382652,-0.15832,-0.986646
3043,0,0,0,0,2028,61,5132,2691,7823,-0.0460563,-0.145934,-0.988222
5822,0,0,0,0,3724,105,9651,4166,13817,-0.0424572,-0.208547,-0.97709
3969,0,0,0,0,2612,79,6660,3572,10232,-0.021736,-0.110847,-0.9936
3996,0,0,0,0,2502,80,6578,3450,10028,-0.0361256,-0.137482,-0.989845
4074,0,0,0,0,2545,77,6696,2746,9442,-0.0481195,-0.140831,-0.988864
5490,0,0,0,0,2466,77,8033,2577,10610,-0.0273353,-0.05401,-0.998166
2566,0,0,0,0,1481,56,4103,2043,6146,-0.0162483,-0.0168847,-0.999725
3375,0,0,0,0,1961,63,5399,2991,8390,-0.0607,-0.176555,-0.982417
7119,0,0,0,0,3958,95,11172,4081,15253,-0.0620278,-0.186884,-0.980422
2888,0,0,0,0,1459,42,4389,3108,7497,-0.0445583,-0.164732,-0.985331
7868,0,0,0,0,2553,93,10514,4285,14799,-0.0454579,-0.175329,-0.98346
2826,0,0,0,0,1230,42,4098,2712,6810,-0.0605579,-0.0783112,-0.995088
4528,0,0,0,0,1366,50,5944,3709,9653,-0.0827803,-0.103384,-0.991191
3398,0,0,0,0,1365,47,4810,3618,8428,-0.0282078,-0.14854,-0.988504
3418,0,0,0,0,1235,46,4699,3391,8090,-0.0569814,-0.19947,-0.978246
5399,0,0,0,0,2090,76,7565,3089,10654,-0.0184255,-0.307421,-0.951395
2273,0,0,0,0,770,25,3068,2792,5860,-0.0339809,-0.2209,-0.974704
2280,0,0,0,0,860,26,3166,2193,5359,-0.026284,-0.168709,-0.985315
2429,0,0,0,0,931,34,3394,2278,5672,-0.0436644,-0.22017,-0.974484
3695,0,0,0,0,1535,47,5277,2934,8211,-0.0352148,-0.0748549,-0.996572
3410,0,0,0,0,1556,46,5012,3231,8243,-0.0372156,-0.186577,-0.981735
5702,0,0,0,0,3008,85,8795,4361,13156,-0.050251,-0.196786,-0.979158
1970,0,0,0,0,1059,34,3063,1564,4627,-0.066828,-0.172626,-0.982718
2487,0,0,0,0,1395,49,3931,2064,5995,-0.0600807,-0.239449,-0.969048
5972,0,0,0,0,3483,112,9567,4119,13686,-0.0291107,-0.203817,-0.978576
3083,0,0,0,0,1978,62,5123,2384,7507,-0.0342822,-0.178728,-0.983301
4990,0,0,0,0,3398,102,8490,5726,14216,-0.090399,-0.124307,-0.988117
4820,0,0,0,0,3671,100,8591,2887,11478,-0.0558748,-0.177189,-0.982589
2270,0,0,0,0,1851,50,4171,1975,6146,-0.0535649,-0.169788,-0.984024
6386,0,0,0,0,5149,141,11676,3499,15175,-0.0493828,-0.277366,-0.959494
2750,0,0,0,0,2311,79,5140,2139,7279,-0.0511979,-0.172846,-0.983617
1665,0,0,0,0,1506,41,3212,1119,4331,-0.0357689,-0.151915,-0.987746
2614,0,0,0,0,2491,71,5176,2314,7490,-0.0383624,-0.169717,-0.984746
6538,0,0,0,0,6154,176,12868,3502,16370,-0.0916202,-0.174657,-0.980357
3362,0,0,0,0,3434,94,6890,2332,9222,-0.118039,-0.109052,-0.987003
5513,0,0,0,0,5528,147,11188,2703,13891,-0.109434,-0.0897684,-0.989932
3163,0,0,0,0,3387,92,6642,1817,8459,-0.0896482,-0.120884,-0.98861
6548,0,0,0,0,7626,202,14376,2694,17070,-0.0951935,-0.112195,-0.989116
3451,0,0,0,0,4365,123,7939,1615,9554,-0.0738537,-0.108836,-0.991312
2526,0,0,0,0,2947,79,5552,1451,7003,-0.0594999,-0.117662,-0.99127
5471,0,0,0,0,7013,177,12661,2283,14944,-0.0796082,-0.132443,-0.987989
3090,0,0,0,0,3530,140,6760,1353,8113,0.0164449,-0.105447,-0.994289
6660,0,0,0,0,6846,185,13691,2199,15890,0.0104314,-0.123077,-0.992342
2611,0,0,0,0,2849,80,5540,1472,7012,0.00218622,-0.117039,-0.993125
6397,0,0,0,0,6529,223,13149,2516,15665,0.0249536,-0.086405,-0.995948
3251,0,0,0,0,3405,90,6746,1735,8481,0.0272638,-0.128106,-0.991386
5080,0,0,0,0,4968,141,10189,2753,12942,0.0087642,-0.112358,-0.993629
5122,0,0,0,0,4471,115,9708,1553,11261,0.0103418,-0.141821,-0.989838
2853,0,0,0,0,2578,77,5508,1624,7132,0.0281526,-0.103288,-0.994253
2887,0,0,0,0,2622,80,5589,1422,7011,0.0334129,-0.10007,-0.994419
3420,0,0,0,0,2719,76,6215,1888,8103,0.04272,-0.118056,-0.992088
5998,0,0,0,0,4396,124,10518,2518,13036,0.0033384,-0.133343,-0.991064
3094,0,0,0,0,2066,60,5220,1911,7131,0.0253523,-0.101925,-0.994469
4728,0,0,0,0,2857,82,7667,2709,10376,0.0432745,-0.124213,-0.991311
5931,0,0,0,0,3362,109,9402,2456,11858,0.0237832,-0.129844,-0.991249
2927,0,0,0,0,1572,47,4546,2033,6579,0.0328339,-0.118721,-0.992385
2915,0,0,0,0,1482,44,4441,1908,6349,0.043404,-0.115229,-0.99239
5934,0,0,0,0,3265,95,9294,3529,12823,0.0142754,-0.125488,-0.991992
4202,0,0,0,0,2492,77,6771,2197,8968,0.0190692,-0.113184,-0.993391
3031,0,0,0,0,1735,52,4818,1789,6607,0.033015,-0.0864653,-0.995708
4009,0,0,0,0,2218,64,6291,2942,9233,-0.016079,-0.106405,-0.994193
3741,0,0,0,0,2312,75,6128,2083,8211,-0.0281328,-0.0858192,-0.995913
3034,0,0,0,0,1687,52,4773,1786,6559,-0.0470593,-0.103978,-0.993466
5801,0,0,0,0,3656,122,9579,2918,12497,-0.0543081,-0.0959112,-0.993907
4073,0,0,0,0,2871,83,7027,2143,9170,-0.0398646,-0.0783137,-0.996131
4139,0,0,0,0,3058,90,7287,2117,9404,-0.0375266,-0.0605216,-0.997461
4363,0,0,0,0,3126,103,7592,2187,9779,-0.00648893,-0.065423,-0.997837
6036,0,0,0,0,4623,138,10797,2755,13552,-0.0348172,-0.0900011,-0.995333
2951,0,0,0,0,1881,53,4885,1203,6088,0.0256705,-0.0508627,-0.998376
1884,0,0,0,0,1260,34,3178,846,4024,-0.0200265,-0.0824094,-0.996397
5947,0,0,0,0,4360,145,10452,2084,12536,-0.0188857,-0.0859396,-0.996121
3139,0,0,0,0,2275,68,5482,2016,7498,-0.022051,-0.0794089,-0.996598
3856,0,0,0,0,2695,97,6648,2168,8816,-0.0746851,-0.122236,-0.989687
5863,0,0,0,0,3927,113,9903,2726,12629,-0.00985063,-0.0724143,-0.997326
6864,0,0,0,0,2617,84,9565,1590,11155,-0.00619335,-0.0688218,-0.99761
2453,0,0,0,0,1604,50,4107,1406,5513,-0.0222499,-0.0832709,-0.996279
5804,0,0,0,0,3795,165,9764,2938,12702,-0.0274697,-0.0982897,-0.994779
3905,0,0,0,0,2643,74,6622,1964,8586,-0.0300807,-0.0872896,-0.995729
3666,0,0,0,0,2448,75,6189,2038,8227,-0.0277797,-0.086764,-0.995842
3652,0,0,0,0,2538,72,6262,2024,8286,-0.0242135,-0.0715359,-0.997144
5903,0,0,0,0,4034,124,10061,2248,12309,-0.0346078,-0.0827897,-0.995966
3043,0,0,0,0,2166,75,5284,2678,7962,-0.0166813,-0.0648987,-0.997752
3675,0,0,0,0,2588,73,6336,2231,8567,-0.0379244,-0.0528911,-0.99788
5779,0,0,0,0,4115,116,10010,2165,12175,-0.0410486,-0.082701,-0.995729
3282,0,0,0,0,2271,62,5615,1724,7339,-0.0639989,-0.100214,-0.992906
5873,0,0,0,0,4465,138,10476,2362,12838,-0.0723056,-0.102437,-0.992108
3081,0,0,0,0,2347,82,5510,2011,7521,-0.0728878,-0.101534,-0.992158
2891,0,0,0,0,2312,69,5272,1611,6883,-0.0892133,-0.101496,-0.990828
6136,0,0,0,0,5108,155,11399,2012,13411,-0.0615966,-0.108719,-0.992162
3056,0,0,0,0,2697,75,5828,1521,7349,-0.0250806,-0.0698516,-0.997242
6054,0,0,0,0,5440,149,11643,2095,13738,-0.0667878,-0.0958281,-0.993155
2718,0,0,0,0,2358,65,5141,1113,6254,-0.0816277,-0.0900232,-0.992589
1645,0,0,0,0,1617,58,3320,818,4138,-0.0501568,-0.0696636,-0.996309
3368,0,0,0,0,3472,128,6968,1822,8790,-0.0632146,-0.0840115,-0.994458
6179,0,0,0,0,5933,162,12274,2568,14842,-0.0626684,-0.0774562,-0.995024
3190,0,0,0,0,3205,94,6489,1605,8094,-0.0634345,-0.0817365,-0.994633
2687,0,0,0,0,2563,70,5320,1245,6565,-0.0727759,-0.0885619,-0.993409
6188,0,0,0,0,6251,182,12621,2518,15139,-0.062673,-0.0774261,-0.995026
3189,0,0,0,0,3329,94,6612,1211,7823,-0.0557585,-0.0740946,-0.995691
2414,0,0,0,0,2643,77,5134,1174,6308,-0.0760163,-0.0726105,-0.994459
4125,0,0,0,0,4447,130,8702,2171,10873,-0.0443328,-0.0675434,-0.996731
4077,0,0,0,0,4382,120,8579,2011,10590,-0.0486078,-0.0662471,-0.996619
3772,0,0,0,0,3357,93,7222,1832,9054,-0.0665006,-0.0642107,-0.995718
4813,0,0,0,0,5259,145,10217,2518,12735,-0.0652515,-0.0703122,-0.995389
3517,0,0,0,0,3737,105,7359,1903,9262,-0.073898,-0.0594876,-0.99549
5965,0,0,0,0,5690,117,11772,1661,13433,-0.0702821,-0.0701659,-0.995056
2557,0,0,0,0,2699,77,5333,1417,6750,-0.0613543,-0.0593971,-0.996347
4487,0,0,0,0,4704,135,9326,2326,11652,-0.0682146,-0.0365532,-0.997001
5941,0,0,0,0,6287,186,12414,1965,14379,-0.0893779,-0.0639103,-0.993945
2538,0,0,0,0,2725,74,5337,1419,6756,-0.0574638,-0.0535628,-0.99691
2998,0,0,0,0,3184,86,6268,1622,7890,-0.059134,-0.0745695,-0.995461
6238,0,0,0,0,7762,200,14200,2215,16415,-0.0988229,-0.0546581,-0.993603
5939,0,0,0,0,4433,88,10460,1532,11992,-0.0315984,-0.05307,-0.998091
2126,0,0,0,0,2161,57,4344,1196,5540,-0.0554953,-0.0425184,-0.997553
4276,0,0,0,0,4580,132,8988,2368,11356,-0.112884,-0.0693827,-0.991183
5480,0,0,0,0,5682,150,11312,3346,14658,-0.0698883,-0.0555982,-0.996004
3865,0,0,0,0,4031,109,8005,2368,10373,-0.114756,-0.0821119,-0.989994
3726,0,0,0,0,3766,114,7606,2130,9736,-0.0339847,-0.0428616,-0.998503
4510,0,0,0,0,4550,141,9201,2712,11913,-0.0925258,-0.135041,-0.986511
3376,0,0,0,0,3339,95,6810,2069,8879,-0.10677,-0.107448,-0.988461
4211,0,0,0,0,4033,119,8363,2829,11192,-0.0892378,-0.0699587,-0.99355
4261,0,0,0,0,3883,111,8255,2418,10673,-0.104865,-0.0766888,-0.991525
4226,0,0,0,0,3968,111,8305,2450,10755,-0.169097,-0.101346,-0.980375
4835,0,0,0,0,3763,105,8703,2282,10985,-0.201252,-0.0966171,-0.974763
4043,0,0,0,0,3684,97,7824,2188,10012,-0.0654147,-0.0460799,-0.996794
3992,0,0,0,0,3601,96,7689,2673,10362,-0.0984691,-0.072495,-0.992496
4337,0,0,0,0,3533,96,7966,2312,10278,-0.102854,-0.0435277,-0.993744
3045,0,0,0,0,2688,73,5806,1857,7663,-0.0574873,0.00524818,-0.998332
3779,0,0,0,0,3249,100,7128,2110,9238,-0.0419837,-0.0102025,-0.999066
3759,0,0,0,0,3343,96,7198,1984,9182,-0.0394889,-0.00536543,-0.999206
4740,0,0,0,0,4240,112,9092,2392,11484,-0.0362031,-0.0166697,-0.999205
3713,0,0,0,0,3096,96,6905,1773,8678,-0.0332659,0.00490819,-0.999434
4455,0,0,0,0,3747,101,8303,2325,10628,-0.0439168,0.00357193,-0.999029
3333,0,0,0,0,2757,73,6163,1641,7804,-0.0812108,-0.0188689,-0.996518
5365,0,0,0,0,4097,121,9583,2620,12203,-0.0773027,0.00325366,-0.997002
3693,0,0,0,0,2687,75,6455,2296,8751,-0.136704,-0.0593785,-0.988831
3700,0,0,0,0,2627,81,6408,2806,9214,-0.0863746,-0.0118467,-0.996192
3737,0,0,0,0,2411,69,6217,2298,8515,-0.0549245,0.0119775,-0.998419
3821,0,0,0,0,2334,72,6227,2130,8357,-0.073172,-0.0308943,-0.996841
2835,0,0,0,0,1714,49,4598,1758,6356,-0.0768746,-0.00326032,-0.997035
4765,0,0,0,0,2482,75,7322,3077,10399,-0.0485893,-0.00254496,-0.998816
5696,0,0,0,0,3289,99,9084,2605,11689,-0.102484,-0.0328509,-0.994192
3253,0,0,0,0,1650,50,4953,1975,6928,-0.100212,-0.0238305,-0.994681
4596,0,0,0,0,2494,82,7172,2928,10100,-0.0906802,-0.0118566,-0.995809
5901,0,0,0,0,3251,90,9242,2949,12191,-0.0805572,-0.0339186,-0.996173
3785,0,0,0,0,2029,70,5884,2668,8552,-0.0624379,-0.0224539,-0.997796
2756,0,0,0,0,1370,47,4173,1840,6013,-0.095107,-0.0408054,-0.99463
6048,0,0,0,0,2795,105,8948,3397,12345,-0.0851536,-0.0358615,-0.995722
3975,0,0,0,0,2055,70,6100,2753,8853,-0.0954236,-0.056754,-0.993818
2919,0,0,0,0,1436,44,4399,2256,6655,-0.0663587,-0.0308926,-0.997317
3092,0,0,0,0,1378,43,4513,2014,6527,-0.0685647,-0.0480551,-0.996489
5557,0,0,0,0,2545,78,8180,3784,11964,-0.0700479,-0.0474403,-0.996415
2847,0,0,0,0,1242,39,4128,2240,6368,-0.10924,-0.0874477,-0.990161
4596,0,0,0,0,1921,61,6578,2627,9205,-0.0976426,-0.0683416,-0.992872
3339,0,0,0,0,1491,59,4889,3243,8132,-0.16546,-0.117411,-0.979203
5624,0,0,0,0,2391,76,8091,3116,11207,-0.110374,-0.120649,-0.98654
5929,0,0,0,0,2783,91,8803,3447,12250,-0.107319,-0.0856909,-0.990525
2645,0,0,0,0,1023,36,3704,1398,5102,-0.130926,-0.0856809,-0.987683
1697,0,0,0,0,806,28,2531,1303,3834,-0.0689356,-0.0576339,-0.995955
5992,0,0,0,0,2852,101,8945,2414,11359,-0.100665,-0.069333,-0.992502
5896,0,0,0,0,2857,105,8858,2874,11732,-0.124328,-0.0908863,-0.98807
2823,0,0,0,0,1310,43,4176,1377,5553,-0.157862,-0.108012,-0.981536
3654,0,0,0,0,2219,54,5927,1706,7633,-0.173814,-0.143258,-0.974303
2072,0,0,0,0,1198,40,3310,1400,4710,-0.19474,-0.141836,-0.970546
6032,0,0,0,0,3801,118,9951,5035,14986,-0.20335,-0.16814,-0.964561
3462,0,0,0,0,1525,48,5035,1996,7031,-0.215641,-0.191567,-0.957497
1710,0,0,0,0,1132,32,2874,2404,5278,-0.0898145,-0.0689435,-0.993569
5641,0,0,0,0,3348,70,9059,3016,12075,-0.150737,-0.128201,-0.980226
2646,0,0,0,0,1424,43,4113,3559,7672,-0.21071,-0.210007,-0.954724
5930,0,0,0,0,3537,86,9553,4876,14429,-0.292386,-0.296743,-0.909095
2302,0,0,0,0,2342,61,4705,2302,7007,-0.324719,-0.32069,-0.889784
4130,0,0,0,0,3898,103,8131,6908,15039,-0.385289,-0.403919,-0.8297
5423,0,0,0,0,5304,141,10868,7233,18101,-0.399577,-0.456684,-0.794845
2074,0,0,0,0,2105,56,4235,4290,8525,-0.340369,-0.396714,-0.852507
2149,0,0,0,0,1820,59,4028,3382,7410,-0.439744,-0.479162,-0.759624
6439,0,0,0,0,6292,179,12910,6291,19201,-0.496922,-0.594905,-0.631789
2651,0,0,0,0,2629,70,5350,3521,8871,-0.541993,-0.623898,-0.563023
6104,0,0,0,0,6008,187,12299,7093,19392,-0.477172,-0.656234,-0.584521
2144,0,0,0,0,2227,60,4431,2987,7418,-0.424202,-0.619225,-0.660767
6173,0,0,0,0,5969,122,12264,5594,17858,-0.404116,-0.612701,-0.679182
2837,0,0,0,0,2296,66,5199,3633,8832,-0.349276,-0.569793,-0.74387
2487,0,0,0,0,2360,69,4916,3084,8000,-0.367231,-0.570315,-0.734767
6060,0,0,0,0,5996,164,12220,7076,19296,-0.351511,-0.557134,-0.752358
3108,0,0,0,0,2871,79,6058,2653,8711,-0.396456,-0.529312,-0.750101
6155,0,0,0,0,3916,105,10176,3838,14014,-0.476699,-0.576821,-0.663352
2124,0,0,0,0,1670,47,3841,2674,6515,-0.468569,-0.61301,-0.63613
4123,0,0,0,0,2864,94,7081,7861,14942,-0.49604,-0.728286,-0.472804
4088,0,0,0,0,2677,86,6851,4485,11336,-0.502952,-0.768982,-0.394596
2035,0,0,0,0,1327,46,3408,6256,9664,-0.515081,-0.782247,-0.3504
3961,0,0,0,0,2339,68,6368,-1,-1,-1,-1,-1
3899,0,0,0,0,2085,72,6056,2463,8519,-0.0931721,-0.116275,-0.988837
3811,0,0,0,0,1806,54,5671,2226,7897,-0.0895661,-0.129628,-0.987509
2740,0,0,0,0,1270,39,4049,1447,5496,-0.0846225,-0.109085,-0.990424
5249,0,0,0,0,2446,65,7760,2284,10044,-0.0850716,-0.100539,-0.991289
4190,0,0,0,0,1787,58,6035,1660,7695,-0.0733108,-0.0852155,-0.993662
4257,0,0,0,0,1397,43,5697,1756,7453,-0.0519024,-0.0712151,-0.99611
5478,0,0,0,0,2124,68,7670,2151,9821,-0.0581083,-0.0675715,-0.996021
3165,0,0,0,0,1532,42,4739,1907,6646,-0.056706,-0.066964,-0.996143
5558,0,0,0,0,2223,76,7857,3555,11412,-0.0697755,-0.0678832,-0.99525
5628,0,0,0,0,2254,73,7955,3734,11689,-0.0745596,-0.0752727,-0.994372
3181,0,0,0,0,914,28,4123,1462,5585,-0.0557417,-0.0567786,-0.996829
1712,0,0,0,0,630,20,2362,1176,3538,-0.0538306,-0.0831022,-0.995086
2914,0,0,0,0,1168,40,4122,2997,7119,-0.0684266,-0.0428979,-0.996733
5501,0,0,0,0,2053,66,7620,3087,10707,-0.0637846,-0.0624478,-0.996008
2853,0,0,0,0,1085,41,3979,2068,6047,-0.0138173,-0.0200115,-0.999704
3432,0,0,0,0,1251,41,4724,3091,7815,-0.0401841,-0.0541146,-0.997726
4405,0,0,0,0,1594,53,6052,3169,9221,-0.0572483,-0.0427878,-0.997443
3235,0,0,0,0,1194,39,4468,3025,7493,-0.0304665,-0.0361967,-0.99888
2811,0,0,0,0,937,30,3778,1961,5739,-0.0477926,-0.0498717,-0.997611
2990,0,0,0,0,1168,38,4196,2931,7127,-0.0446645,-0.0941083,-0.99456
5664,0,0,0,0,2354,80,8098,2986,11084,-0.0274949,-0.0936933,-0.995221
2922,0,0,0,0,1757,49,4728,2137,6865,0.00121949,-0.0862156,-0.996276
5606,0,0,0,0,2865,102,8573,4290,12863,-0.00817519,-0.0987603,-0.995078
3811,0,0,0,0,1853,61,5725,2453,8178,-0.00320717,-0.135736,-0.99074
2353,0,0,0,0,1113,35,3501,2734,6235,0.0212623,-0.076557,-0.996838
4183,0,0,0,0,1977,60,6220,3388,9608,0.0229957,-0.0958252,-0.995133
4233,0,0,0,0,2191,88,6512,2599,9111,0.0396464,-0.097602,-0.994436
3100,0,0,0,0,1548,47,4695,2352,7047,0.0380718,-0.0800067,-0.996067
3900,0,0,0,0,1963,69,5932,2841,8773,0.0429721,-0.0860366,-0.995365
3856,0,0,0,0,2011,70,5937,2693,8630,0.0465777,-0.0862155,-0.995187
3963,0,0,0,0,1984,61,6008,2510,8518,0.0304369,-0.0824842,-0.996127
5685,0,0,0,0,2888,101,8674,2375,11049,0.0453673,-0.0976888,-0.994182
2974,0,0,0,0,1547,46,4567,1728,6295,0.0364225,-0.104182,-0.993891
3608,0,0,0,0,2054,66,5728,2159,7887,0.0431877,-0.0772394,-0.996077
3539,0,0,0,0,2014,59,5612,1871,7483,0.0350594,-0.110197,-0.993291
5912,0,0,0,0,3405,110,9427,2450,11877,0.0484573,-0.0946102,-0.994334
2982,0,0,0,0,1857,55,4894,1618,6512,0.0190882,-0.103473,-0.994449
5659,0,0,0,0,3778,118,9555,2038,11593,0.0271361,-0.123638,-0.991956
2953,0,0,0,0,2185,66,5204,1564,6768,0.044118,-0.105519,-0.993438
5812,0,0,0,0,4197,124,10133,2992,13125,0.0379104,-0.114009,-0.992756
3967,0,0,0,0,3011,92,7070,1677,8747,0.0613606,-0.0920241,-0.993864
2815,0,0,0,0,2314,64,5193,1618,6811,0.0285414,-0.0880465,-0.995707
6165,0,0,0,0,4958,139,11262,2179,13441,0.00533362,-0.0869569,-0.996198
3072,0,0,0,0,2684,72,5828,1740,7568,0.00950306,-0.0836757,-0.996448
4961,0,0,0,0,4431,123,9515,2135,11650,0.030793,-0.0893499,-0.995524
5952,0,0,0,0,5530,152,11634,2132,13766,-0.0150962,-0.0936787,-0.995488
2958,0,0,0,0,2471,75,5504,1027,6531,-0.0222129,-0.0711678,-0.997217
1739,0,0,0,0,1646,44,3429,815,4244,-0.0118691,-0.0674844,-0.99765
1904,0,0,0,0,2040,57,4001,947,4948,-0.00199957,-0.0452702,-0.998973
5994,0,0,0,0,7057,184,13235,2761,15996,-0.00993549,-0.0615396,-0.998055
3517,0,0,0,0,3697,113,7327,1256,8583,0.0112813,-0.0525809,-0.998553
2560,0,0,0,0,3049,80,5689,1432,7121,-0.00225963,-0.0480063,-0.998844
6185,0,0,0,0,7595,262,14042,2211,16253,-0.0181379,-0.0967038,-0.995148
6841,0,0,0,0,4534,117,11492,1230,12722,-0.0105981,-0.0685787,-0.997589
2191,0,0,0,0,2751,77,5019,1147,6166,-0.0136219,-0.061041,-0.998042
3498,0,0,0,0,4615,119,8232,1828,10060,-0.00667394,-0.0716716,-0.997406
5949,0,0,0,0,7197,203,13349,3084,16433,0.0355025,-0.0938942,-0.994949
6232,0,0,0,0,6496,127,12855,3747,16602,-0.0695398,-0.110363,-0.991456
2115,0,0,0,0,2452,63,4630,1251,5881,-0.107163,-0.147325,-0.983266
4041,0,0,0,0,3935,110,8086,2389,10475,-0.0398789,-0.114925,-0.992573
6097,0,0,0,0,5029,143,11269,2396,13665,-0.0827804,-0.198176,-0.976665
3090,0,0,0,0,2339,64,5493,1765,7258,0.211486,-0.360345,-0.908529
2332,0,0,0,0,1640,46,4018,4429,8447,-0.00976858,-0.454309,-0.890791
2316,0,0,0,0,1485,43,3844,6334,10178,-0.428661,-0.498974,-0.753176
5561,0,0,0,0,3136,90,8787,3532,12319,-0.0344103,-0.103895,-0.993993
2930,0,0,0,0,1522,37,4489,1354,5843,-0.0341269,-0.0373345,-0.99872
1975,0,0,0,0,964,29,2968,1104,4072,-0.02693,-0.0338745,-0.999063
2881,0,0,0,0,1343,42,4266,1848,6114,-0.0439282,-0.0686924,-0.99667
5597,0,0,0,0,2434,74,8105,2541,10646,-0.0138924,-0.0304492,-0.99944
2991,0,0,0,0,1159,45,4195,1889,6084,-0.0591959,-0.0498435,-0.997001
5247,0,0,0,0,2033,75,7355,2282,9637,-0.0874773,-0.130789,-0.987543
3431,0,0,0,0,849,32,4312,1102,5414,-0.0621737,-0.0676753,-0.995768
1623,0,0,0,0,570,19,2212,870,3082,-0.0598504,-0.066681,-0.995978
1505,0,0,0,0,540,20,2065,1011,3076,-0.057201,-0.0689429,-0.995979
5445,0,0,0,0,1799,65,7309,3866,11175,-0.060515,-0.0858351,-0.99447
5291,0,0,0,0,1905,70,7266,1964,9230,-0.0198119,-0.048614,-0.998621
2259,0,0,0,0,686,24,2969,1414,4383,-0.0448067,-0.0578778,-0.997318
2626,0,0,0,0,795,26,3447,1694,5141,-0.0421245,-0.116634,-0.992281
3116,0,0,0,0,843,30,3989,1841,5830,-0.0216735,-0.103405,-0.994403
5677,0,0,0,0,1453,52,7182,3356,10538,-0.0247105,-0.0766046,-0.996755
3738,0,0,0,0,903,34,4675,1800,6475,-0.0115127,-0.0944653,-0.995462
3282,0,0,0,0,809,28,4119,1899,6018,-0.00679152,-0.100699,-0.994894
5122,0,0,0,0,1170,50,6342,3180,9522,-0.00995695,-0.104543,-0.994471
7390,0,0,0,0,1126,38,8554,1641,10195,-0.0339258,-0.0966194,-0.994743
2721,0,0,0,0,673,28,3422,1563,4985,-0.0264743,-0.117342,-0.992739
2431,0,0,0,0,703,31,3165,1235,4400,-0.0277906,-0.112077,-0.993311
2816,0,0,0,0,717,32,3565,1430,4995,-0.0281082,-0.112716,-0.99323
5416,0,0,0,0,1521,57,6994,2992,9986,-0.00507369,-0.140947,-0.990004
3698,0,0,0,0,1388,49,5135,2327,7462,-0.0133995,-0.136265,-0.990582
2827,0,0,0,0,1070,36,3933,1559,5492,0.00315828,-0.135483,-0.990775
6342,0,0,0,0,2079,72,8493,2269,10762,0.0112456,-0.173044,-0.98485
5490,0,0,0,0,2126,69,7685,2027,9712,0.00585229,-0.145063,-0.989405
3009,0,0,0,0,1265,39,4313,1642,5955,0.0062924,-0.129243,-0.991593
5480,0,0,0,0,2496,78,8054,3252,11306,-0.0141239,-0.161369,-0.986793
3817,0,0,0,0,1923,63,5803,4033,9836,-0.0241844,-0.210778,-0.977235
5649,0,0,0,0,3293,100,9042,5851,14893,0.00342223,-0.22436,-0.9745
2357,0,0,0,0,1524,43,3924,3319,7243,0.00807565,-0.327514,-0.944812
4186,0,0,0,0,3177,106,7469,5153,12622,-0.273716,0.180829,-0.944659
4303,0,0,0,0,4174,103,8580,3302,11882,-0.0167512,-0.150367,-0.988488
7388,0,0,0,0,5031,100,12519,9681,22200,-0.0757363,-0.145781,-0.986414
4010,0,0,0,0,3114,79,7203,8666,15869,0.00273923,-0.114429,-0.993428
1623,0,0,0,0,1596,48,3267,3007,6274,0.0612582,-0.11671,-0.991275
2577,0,0,0,0,2595,82,5254,2077,7331,0.117102,-0.173321,-0.977879
6027,0,0,0,0,5943,179,12149,4498,16647,-0.111205,-0.270483,-0.956281
2512,0,0,0,0,2383,66,4961,1862,6823,-0.080239,-0.295622,-0.951929
5968,0,0,0,0,5198,143,11309,2884,14193,-0.0304311,-0.304873,-0.951907
3041,0,0,0,0,2504,73,5618,1876,7494,0.0204994,-0.159001,-0.987066
3051,0,0,0,0,2236,65,5352,1552,6904,0.0290975,-0.165091,-0.985849
5902,0,0,0,0,3586,110,9598,2093,11691,0.0419597,-0.165159,-0.985374
2966,0,0,0,0,1531,48,4545,1450,5995,0.0370627,-0.150979,-0.987842
4584,0,0,0,0,2130,89,6803,2463,9266,0.0595376,-0.176335,-0.982528
4455,0,0,0,0,1802,60,6317,1837,8154,0.0491325,-0.13788,-0.98923
5465,0,0,0,0,2064,68,7597,2018,9615,0.0380004,-0.151753,-0.987688
2856,0,0,0,0,1034,35,3925,1510,5435,0.0184351,-0.113123,-0.99341
4396,0,0,0,0,1486,51,5933,2294,8227,0.0387711,-0.135078,-0.990076
5389,0,0,0,0,1693,67,7149,2808,9957,0.0401877,-0.128519,-0.990892
3661,0,0,0,0,1094,39,4794,1852,6646,0.0424628,-0.118137,-0.992089
5487,0,0,0,0,1520,54,7061,3936,10997,0.0436893,-0.181078,-0.982498
2777,0,0,0,0,621,22,3420,1295,4715,0.0397349,-0.152688,-0.987475
2073,0,0,0,0,497,17,2587,915,3502,0.0343377,-0.113726,-0.992919
2092,0,0,0,0,677,23,2792,1202,3994,0.0280305,-0.122368,-0.992089
5901,0,0,0,0,2089,74,8064,3130,11194,0.0648539,-0.146665,-0.987058
3092,0,0,0,0,1205,40,4337,2370,6707,0.0389914,-0.131549,-0.990543
1213,0,0,0,0,478,15,1706,693,2399,0.0548446,-0.100501,-0.993424
5334,0,0,0,0,2292,72,7698,3373,11071,0.0513992,-0.151453,-0.987127
3181,0,0,0,0,1094,30,4305,1378,5683,0.0339742,-0.128276,-0.991156
1714,0,0,0,0,849,30,2593,882,3475,0.0265931,-0.101486,-0.994481
2796,0,0,0,0,1109,35,3940,1643,5583,0.0375606,-0.0972267,-0.994553
5343,0,0,0,0,2083,77,7503,2363,9866,0.0650974,-0.0906481,-0.993753
2811,0,0,0,0,1140,41,3992,2180,6172,0.0205792,-0.100833,-0.99469
5364,0,0,0,0,2107,68,7539,3093,10632,0.0223372,-0.130423,-0.991207
2815,0,0,0,0,1061,29,3905,1613,5518,-0.0134786,-0.129484,-0.99149
1671,0,0,0,0,664,21,2356,1063,3419,0.0220555,-0.116029,-0.993001
1943,0,0,0,0,840,27,2810,1316,4126,0.0653119,-0.0677723,-0.995561
5403,0,0,0,0,2318,75,7796,3101,10897,0.00876938,-0.107923,-0.994121
3828,0,0,0,0,1663,58,5549,2953,8502,0.0173274,-0.0458104,-0.9988
3880,0,0,0,0,2340,65,6285,2546,8831,0.0207021,-0.0206449,-0.999573
2804,0,0,0,0,1309,45,4158,1653,5811,0.0129968,-0.0854659,-0.996256
6300,0,0,0,0,2693,92,9085,3019,12104,-0.00244686,-0.110027,-0.993926
3790,0,0,0,0,1846,62,5698,1546,7244,0.0110216,-0.0903117,-0.995853
2493,0,0,0,0,1299,42,3834,1428,5262,0.0114673,-0.10311,-0.994604
5400,0,0,0,0,2756,93,8249,3416,11665,0.0160618,-0.101685,-0.994687
3006,0,0,0,0,1465,45,4516,1544,6060,0.0148002,-0.107465,-0.994099
5769,0,0,0,0,2853,89,8711,2280,10991,0.0104721,-0.174495,-0.984602
3170,0,0,0,0,1271,40,4481,1107,5588,0.0348662,-0.115947,-0.992643
5338,0,0,0,0,2132,74,7544,1474,9018,0.0111695,-0.0919883,-0.995697
5422,0,0,0,0,3291,104,8817,2674,11491,0.0136369,-0.11255,-0.993553
2337,0,0,0,0,1503,47,3887,1253,5140,-0.00314538,-0.0765777,-0.997059
5676,0,0,0,0,3473,114,9263,2149,11412,0.00528969,-0.105248,-0.994432
3062,0,0,0,0,1872,77,5011,1624,6635,0.0084129,-0.0950427,-0.995438
4475,0,0,0,0,3011,95,7581,2293,9874,-0.00237627,-0.0722743,-0.997382
4558,0,0,0,0,3176,99,7833,1718,9551,0.0297443,-0.102049,-0.994335
1851,0,0,0,0,1468,48,3367,958,4325,0.0356312,-0.0584762,-0.997653
3350,0,0,0,0,2493,71,5914,1818,7732,0.0231627,-0.0982018,-0.994897
3381,0,0,0,0,2771,90,6242,1715,7957,0.0368874,-0.105387,-0.993747
5718,0,0,0,0,4628,131,10477,2081,12558,0.016017,-0.0964048,-0.995213
2266,0,0,0,0,1826,55,4147,1016,5163,0.0124014,-0.0814757,-0.996598
3932,0,0,0,0,3637,100,7669,1872,9541,0.0151684,-0.0975904,-0.995111
5773,0,0,0,0,3539,103,9415,1912,11327,0.00255256,-0.0899669,-0.995941
3966,0,0,0,0,3313,93,7372,2022,9394,0.0124442,-0.0752141,-0.99709
5280,0,0,0,0,3998,114,9392,2510,11902,-0.00339358,-0.0939825,-0.995568
3699,0,0,0,0,2775,77,6551,1847,8398,0.00514845,-0.0838295,-0.996467
1919,0,0,0,0,1471,39,3429,951,4380,-0.00421911,-0.0693603,-0.997583
5667,0,0,0,0,3767,109,9543,2505,12048,-0.0193344,-0.136815,-0.990408
2732,0,0,0,0,1518,44,4294,989,5283,0.00108964,-0.099134,-0.995073
1662,0,0,0,0,970,31,2663,820,3483,0.000271801,-0.0684072,-0.997657
1275,0,0,0,0,852,20,2147,642,2789,-0.0242061,-0.0415556,-0.998843
1443,0,0,0,0,741,24,2208,700,2908,-0.00972413,-0.0251255,-0.999637
2362,0,0,0,0,1376,41,3779,1370,5149,-0.0256497,-0.0127283,-0.99959
5748,0,0,0,0,2955,88,8791,2230,11021,-0.0255569,0.00207178,-0.999671
5298,0,0,0,0,2804,86,8188,2709,10897,-0.0514476,0.0286028,-0.998266
2270,0,0,0,0,1199,36,3505,1096,4601,-0.03194,0.0399051,-0.998693
1492,0,0,0,0,777,23,2292,833,3125,-0.0315937,0.0322591,-0.99898
1565,0,0,0,0,924,28,2517,818,3335,-0.0229378,0.0399838,-0.998937
5781,0,0,0,0,3456,105,9342,2867,12209,-0.0285016,0.0672935,-0.997326
5484,0,0,0,0,3918,134,9536,1480,11016,-0.0280925,0.0823762,-0.996205
3079,0,0,0,0,1821,51,4951,1274,6225,-0.0382202,0.0894985,-0.995253
4137,0,0,0,0,3262,105,7504,2048,9552,-0.0275921,0.0940949,-0.995181
4834,0,0,0,0,3286,91,8211,2095,10306,-0.00471539,0.098203,-0.995155
4292,0,0,0,0,3368,97,7757,2122,9879,-0.011553,0.0931383,-0.995586
3280,0,0,0,0,2576,76,5932,1671,7603,0.0183565,0.105391,-0.994261
3959,0,0,0,0,3199,92,7250,2116,9366,0.0231375,0.108556,-0.993821
6817,0,0,0,0,4879,165,11861,2073,13934,0.0197794,0.116781,-0.992961
3960,0,0,0,0,3552,106,7618,2235,9853,0.0193608,0.143948,-0.989396
3510,0,0,0,0,2981,85,6576,1510,8086,0.0305548,0.142693,-0.989295
3169,0,0,0,0,1982,57,5208,1191,6399,0.0346314,0.146687,-0.988576
1406,0,0,0,0,1095,32,2533,711,3244,0.00814764,0.114404,-0.993401
