Downsample[ns],BuildFilTree[ns],SearchFil[ns],DeleteFil[ns],BuildTreeSub[ns],SearchSub[ns],DeleteSub[ns],PreProcTotal[ns],Plane[ns],Total[ns],nx,ny,nz
6878,0,0,0,0,7119,187,14184,939,15123,0.0139578,-0.0500593,-0.998649
2922,0,0,0,0,3709,96,6727,747,7474,0.0299294,-0.0842497,-0.995995
2724,0,0,0,0,3705,96,6525,903,7428,0.00450454,-0.0444973,-0.998999
6325,0,0,0,0,8281,210,14816,1883,16699,-0.038866,-0.0457773,-0.998195
4952,0,0,0,0,6107,169,11228,937,12165,-0.0463877,-0.046896,-0.997822
2371,0,0,0,0,3043,88,5502,714,6216,-0.0486833,-0.0416749,-0.997944
3537,0,0,0,0,3411,99,7047,793,7840,-0.073345,-0.0258095,-0.996973
3313,0,0,0,0,4145,91,7549,831,8380,-0.0377862,-0.0171741,-0.999138
2656,0,0,0,0,3597,87,6340,448,6788,-0.0503457,0.00103616,-0.998731
2338,0,0,0,0,3115,204,5657,597,6254,-0.00748531,-0.0249068,-0.999662
2497,0,0,0,0,3615,119,6231,902,7133,-0.0129097,-0.0349032,-0.999307
2442,0,0,0,0,3202,84,5728,1168,6896,0.0126152,-0.077496,-0.996913
2653,0,0,0,0,3299,87,6039,602,6641,0.00429754,-0.10074,-0.994904
2238,0,0,0,0,3047,79,5364,589,5953,0.00339986,-0.0373391,-0.999297
6850,0,0,0,0,8378,153,15381,1175,16556,-0.0019734,-0.0733543,-0.997304
6829,0,0,0,0,8499,158,15486,1559,17045,-0.000235505,-0.0419745,-0.999119
6707,0,0,0,0,6751,164,13622,1088,14710,0.0151686,-0.0146277,-0.999778
2788,0,0,0,0,3779,105,6672,1331,8003,0.0190201,0.0626408,-0.997855
5066,0,0,0,0,6820,176,12062,1376,13438,-0.00662569,0.0155975,-0.999856
9364,0,0,0,0,8263,160,17787,1206,18993,-0.0269431,0.0199844,-0.999437
2475,0,0,0,0,3460,96,6031,785,6816,-0.0691515,0.0207017,-0.997391
2263,0,0,0,0,2880,63,5206,523,5729,-0.065676,0.0116467,-0.997773
2326,0,0,0,0,3105,77,5508,589,6097,-0.0569394,0.0039772,-0.99837
2234,0,0,0,0,2921,61,5216,453,5669,-0.0703293,-0.0182778,-0.997356
2248,0,0,0,0,3035,65,5348,511,5859,-0.0861295,-0.0138402,-0.996188
2211,0,0,0,0,2864,79,5154,649,5803,-0.0856262,0.0109613,-0.996267
2282,0,0,0,0,3056,63,5401,698,6099,-0.056576,0.0232194,-0.998128
2206,0,0,0,0,2956,59,5221,568,5789,-0.0173996,-0.0467808,-0.998754
2224,0,0,0,0,2900,80,5204,555,5759,-0.0186615,-0.0288672,-0.999409
2408,0,0,0,0,3018,67,5493,763,6256,-0.0485214,-0.0153238,-0.998705
2215,0,0,0,0,2914,87,5216,668,5884,-0.0218583,-0.0404381,-0.998943
2054,0,0,0,0,2114,58,4226,444,4670,-0.0367272,-0.0629209,-0.997343
1552,0,0,0,0,2050,54,3656,287,3943,-0.0285716,-0.0615651,-0.997694
1509,0,0,0,0,2007,52,3568,539,4107,-0.0741259,-0.0941508,-0.992795
1569,0,0,0,0,2062,54,3685,363,4048,-0.00835976,-0.0369227,-0.999283
1496,0,0,0,0,2056,57,3609,497,4106,-0.00951527,-0.0476602,-0.998818
1407,0,0,0,0,2075,50,3532,467,3999,-0.00252296,-0.0314452,-0.999502
2169,0,0,0,0,2771,62,5002,767,5769,-0.0214336,-0.0153831,-0.999652
2212,0,0,0,0,2790,60,5062,541,5603,-0.0725406,0.0331955,-0.996813
1507,0,0,0,0,2041,73,3621,380,4001,-0.0851287,-0.0158527,-0.996244
1611,0,0,0,0,1986,77,3674,254,3928,-0.0747581,0.0115917,-0.997134
1595,0,0,0,0,1943,77,3615,413,4028,-0.0567709,-0.000532863,-0.998387
2094,0,0,0,0,2756,61,4911,420,5331,-0.0478944,0.0403671,-0.998036
2108,0,0,0,0,2966,114,5188,449,5637,-0.0654233,-0.00722036,-0.997831
2102,0,0,0,0,2790,97,4989,647,5636,-0.0347624,-0.015751,-0.999271
2141,0,0,0,0,2810,61,5012,613,5625,-0.0351813,-0.0164913,-0.999245
2338,0,0,0,0,2948,71,5357,531,5888,-0.0386405,-0.00570194,-0.999237
1808,0,0,0,0,2348,76,4232,300,4532,-0.0399288,0.00255417,-0.999199
1825,0,0,0,0,2425,63,4313,451,4764,-0.034215,-0.00730014,-0.999388
2357,0,0,0,0,3114,86,5557,599,6156,-0.0767184,-0.018551,-0.99688
4743,0,0,0,0,6409,184,11336,1082,12418,-0.0444573,0.030157,-0.998556
4911,0,0,0,0,6454,165,11530,1187,12717,-0.0610195,-0.00837919,-0.998101
3435,0,0,0,0,4970,149,8554,800,9354,-0.0426486,0.0290146,-0.998669
3628,0,0,0,0,4820,152,8600,1120,9720,-0.045938,0.0346163,-0.998344
9217,0,0,0,0,8780,173,18170,1131,19301,-0.0756014,-0.0194411,-0.996949
2765,0,0,0,0,3926,119,6810,947,7757,-0.00932535,-0.0328875,-0.999416
2778,0,0,0,0,3733,117,6628,822,7450,-0.00556794,-0.0460593,-0.998923
6814,0,0,0,0,9033,248,16095,1819,17914,-0.0323038,-0.061611,-0.997577
3417,0,0,0,0,5066,136,8619,880,9499,-0.0421037,-0.0763551,-0.996191
3502,0,0,0,0,4936,155,8593,1153,9746,-0.077783,-0.097814,-0.99216
7036,0,0,0,0,8739,237,16012,1293,17305,0.00260043,-0.0388872,-0.99924
4315,0,0,0,0,6385,157,10857,1529,12386,0.0056528,-0.00960857,-0.999938
1994,0,0,0,0,2605,76,4675,637,5312,-0.0156527,0.00252052,-0.999874
2495,0,0,0,0,3302,78,5875,481,6356,-0.0428197,0.0158694,-0.998957
1835,0,0,0,0,2342,66,4243,415,4658,-0.0763408,0.0261527,-0.996739
1992,0,0,0,0,2446,79,4517,481,4998,-0.0514972,0.00273546,-0.998669
3712,0,0,0,0,4683,111,8506,647,9153,-0.0475879,-0.00707864,-0.998842
3660,0,0,0,0,4286,130,8076,724,8800,-0.0469635,-0.00920193,-0.998854
4399,0,0,0,0,3447,91,7937,653,8590,-0.0537618,-0.00936179,-0.99851
2210,0,0,0,0,2803,79,5092,526,5618,-0.0403157,-0.0059595,-0.999169
2216,0,0,0,0,2857,84,5157,641,5798,-0.0543678,0.044541,-0.997527
3392,0,0,0,0,4538,122,8052,1032,9084,-0.00688249,0.0754042,-0.997129
4732,0,0,0,0,5172,135,10039,982,11021,-0.00378457,0.0738851,-0.99726
4314,0,0,0,0,5404,134,9852,1228,11080,-0.0161804,0.103979,-0.994448
4408,0,0,0,0,4946,130,9484,1087,10571,-0.0155173,0.0924218,-0.995599
7180,0,0,0,0,7702,162,15044,1587,16631,-0.0436056,0.0497719,-0.997808
2911,0,0,0,0,3182,88,6181,624,6805,-0.0245357,0.0571908,-0.998062
2584,0,0,0,0,2805,72,5461,943,6404,-0.00948478,-0.0176303,-0.9998
1959,0,0,0,0,2073,52,4084,449,4533,-0.0250377,0.0199625,-0.999487
1788,0,0,0,0,1907,51,3746,572,4318,-0.0376211,0.0361824,-0.998637
2892,0,0,0,0,2967,79,5938,707,6645,-0.0409999,0.0285773,-0.99875
6068,0,0,0,0,6006,184,12258,1607,13865,-0.0735979,0.0690381,-0.994896
6193,0,0,0,0,6534,170,12897,1266,14163,-0.082285,0.0834321,-0.99311
4084,0,0,0,0,3564,114,7762,1122,8884,-0.0850397,0.0747915,-0.993567
3156,0,0,0,0,4154,125,7435,871,8306,-0.0031426,-0.0195369,-0.999804
2568,0,0,0,0,3188,80,5836,1096,6932,-0.00371221,-0.0621521,-0.99806
5059,0,0,0,0,5466,168,10693,1312,12005,-0.0102873,-0.0846943,-0.996354
5180,0,0,0,0,5230,172,10582,854,11436,0.00355654,-0.0403838,-0.999178
2744,0,0,0,0,3358,123,6225,1205,7430,0.0198931,-0.0278787,-0.999413
3324,0,0,0,0,4356,107,7787,1707,9494,0.0348702,-0.00651135,-0.999371
3186,0,0,0,0,4279,115,7580,1398,8978,0.0403517,0.0342063,-0.9986
3594,0,0,0,0,3816,105,7515,1200,8715,0.0612905,0.0324087,-0.997594
2061,0,0,0,0,1930,55,4046,586,4632,0.0897717,0.0113471,-0.995898
2011,0,0,0,0,2133,56,4200,632,4832,0.083819,-0.03161,-0.99598
3494,0,0,0,0,3846,92,7432,863,8295,0.00256655,-0.0653813,-0.997857
2953,0,0,0,0,2964,102,6019,946,6965,-0.0244385,-0.11715,-0.992813
2912,0,0,0,0,3236,89,6237,582,6819,-0.0218104,-0.0271751,-0.999393
5977,0,0,0,0,4596,95,10668,1245,11913,-0.0266638,-0.0218688,-0.999405
2162,0,0,0,0,2512,95,4769,896,5665,-0.0255369,-0.0464876,-0.998592
5448,0,0,0,0,4220,91,9759,956,10715,-0.036228,-0.0108026,-0.999285
2656,0,0,0,0,3057,80,5793,1218,7011,-0.0313534,-0.0463764,-0.998432
4715,0,0,0,0,5109,132,9956,2517,12473,-0.0517571,-0.0260993,-0.998319
4805,0,0,0,0,5156,143,10104,1604,11708,-0.0594996,-0.0978309,-0.993423
5067,0,0,0,0,5514,114,10695,886,11581,-0.0705213,-0.132732,-0.98864
2848,0,0,0,0,3391,100,6339,804,7143,0.015702,-0.0221463,-0.999631
1937,0,0,0,0,2156,56,4149,556,4705,0.0115305,-0.040352,-0.999119
3250,0,0,0,0,3716,110,7076,1210,8286,-0.00968809,-0.0380088,-0.99923
3214,0,0,0,0,3612,110,6936,1651,8587,-0.00430557,-0.0795549,-0.996821
6537,0,0,0,0,6611,125,13273,1151,14424,-0.0308794,-0.126674,-0.991464
3203,0,0,0,0,3431,92,6726,811,7537,-0.00450938,-0.061129,-0.99812
6177,0,0,0,0,6407,179,12763,2656,15419,-0.0356928,-0.0958347,-0.994757
6106,0,0,0,0,6195,144,12445,1297,13742,-0.0219325,-0.0553494,-0.998226
3218,0,0,0,0,3910,94,7222,1007,8229,-0.0169127,-0.0718818,-0.99727
6120,0,0,0,0,6863,176,13159,1234,14393,-0.00937374,-0.0484125,-0.998783
6422,0,0,0,0,6785,188,13395,2502,15897,-0.0307886,-0.0683686,-0.997185
3147,0,0,0,0,2779,78,6004,585,6589,0.00342889,-0.0459357,-0.998939
2238,0,0,0,0,2467,68,4773,849,5622,-0.0444736,-0.0370379,-0.998324
2102,0,0,0,0,2312,64,4478,669,5147,-0.0481786,-0.0357258,-0.9982
6261,0,0,0,0,6666,197,13124,1581,14705,-0.002233,-0.0497414,-0.99876
6136,0,0,0,0,6290,144,12570,1031,13601,-0.0255182,-0.0797927,-0.996485
3179,0,0,0,0,3520,100,6799,531,7330,-0.00362859,-0.0336248,-0.999428
6142,0,0,0,0,6642,170,12954,1632,14586,0.00266078,-0.0219018,-0.999757
4304,0,0,0,0,4609,120,9033,920,9953,0.00186269,-0.0160079,-0.99987
6086,0,0,0,0,6393,181,12660,1606,14266,0.00327315,-0.0185845,-0.999822
4208,0,0,0,0,4285,128,8621,1250,9871,0.0139212,-0.0503103,-0.998637
5480,0,0,0,0,5588,157,11225,2383,13608,0.0270118,-0.109814,-0.993585
5651,0,0,0,0,4858,132,10641,960,11601,0.00645746,-0.0607931,-0.99813
4870,0,0,0,0,5351,129,10350,586,10936,-0.00364272,-0.0557274,-0.998439
3851,0,0,0,0,3498,93,7442,711,8153,-0.011866,-0.0501934,-0.998669
6195,0,0,0,0,5576,148,11919,1028,12947,-0.0118804,-0.0573791,-0.998282
5815,0,0,0,0,3590,99,9504,636,10140,0.00445562,-0.0646172,-0.9979
2478,0,0,0,0,2042,55,4575,314,4889,0.0139956,-0.0872182,-0.996091
5780,0,0,0,0,4173,116,10069,1446,11515,0.00447489,-0.0649991,-0.997875
6236,0,0,0,0,5006,105,11347,831,12178,0.00373835,-0.0707716,-0.997486
6432,0,0,0,0,3723,98,10253,769,11022,0.00799861,-0.0641868,-0.997906
3095,0,0,0,0,2470,69,5634,577,6211,0.018035,-0.0576284,-0.998175
5703,0,0,0,0,3573,113,9389,1042,10431,0.0175165,-0.0394107,-0.99907
4768,0,0,0,0,3430,98,8296,1276,9572,0.0101878,-0.0906768,-0.995828
5543,0,0,0,0,3325,95,8963,788,9751,0.0246079,-0.0656717,-0.997538
5831,0,0,0,0,4011,115,9957,1133,11090,0.0112198,-0.0906693,-0.995818
4064,0,0,0,0,2782,81,6927,973,7900,-0.0166761,-0.104074,-0.99443
6235,0,0,0,0,3880,133,10248,1083,11331,0.00851472,-0.064551,-0.997878
6259,0,0,0,0,3792,126,10177,1383,11560,0.018342,-0.0732022,-0.997148
5800,0,0,0,0,3904,122,9826,1703,11529,0.0207051,-0.119092,-0.992667
3405,0,0,0,0,1953,63,5421,880,6301,0.0228808,-0.0924958,-0.99545
2054,0,0,0,0,1094,36,3184,335,3519,0.00385126,-0.0984632,-0.995133
2106,0,0,0,0,1284,42,3432,764,4196,0.000626276,-0.0920116,-0.995758
5755,0,0,0,0,3657,120,9532,1798,11330,0.00691018,-0.1012,-0.994842
6738,0,0,0,0,3674,120,10532,1207,11739,0.0487416,-0.00307321,-0.998807
2930,0,0,0,0,1995,56,4981,797,5778,0.0298602,-0.0462266,-0.998485
5879,0,0,0,0,3977,110,9966,1343,11309,0.0125185,-0.101964,-0.994709
5804,0,0,0,0,3937,112,9853,1321,11174,0.00634293,-0.0875526,-0.99614
3932,0,0,0,0,2702,78,6712,700,7412,-0.003911,-0.0558106,-0.998434
5543,0,0,0,0,3955,122,9620,1006,10626,-0.00484123,-0.0626411,-0.998024
5606,0,0,0,0,3870,112,9588,1326,10914,-0.00961126,-0.0319546,-0.999443
5671,0,0,0,0,3934,113,9718,1104,10822,0.00762526,-0.0493619,-0.998752
4044,0,0,0,0,2931,90,7065,1334,8399,0.0181649,0.00587061,-0.999818
4449,0,0,0,0,3055,95,7599,865,8464,-0.0161977,-0.0550848,-0.99835
5811,0,0,0,0,4623,138,10572,1605,12177,-0.00222572,-0.0621822,-0.998062
6112,0,0,0,0,4281,96,10489,1291,11780,-0.0113793,-0.0729007,-0.997274
3294,0,0,0,0,2486,72,5852,950,6802,0.00476263,-0.0807599,-0.996722
5901,0,0,0,0,4609,128,10638,1554,12192,0.00253455,-0.0992053,-0.995064
5795,0,0,0,0,5011,152,10958,1083,12041,0.0195346,-0.0488485,-0.998615
4214,0,0,0,0,3163,86,7463,813,8276,0.0260995,-0.0855442,-0.995992
5324,0,0,0,0,4181,115,9620,1913,11533,0.0146704,-0.0443228,-0.99891
5255,0,0,0,0,3990,113,9358,978,10336,0.0234199,-0.0984729,-0.994864
5233,0,0,0,0,4018,130,9381,1582,10963,0.0141449,-0.0569591,-0.998276
3629,0,0,0,0,2789,77,6495,1357,7852,0.00788307,-0.119707,-0.992778
5870,0,0,0,0,4300,135,10305,1675,11980,0.018803,-0.0789526,-0.996701
3917,0,0,0,0,2851,80,6848,1144,7992,0.00137039,-0.0721399,-0.997394
5622,0,0,0,0,4059,120,9801,1254,11055,0.0199649,-0.057003,-0.998174
3857,0,0,0,0,2834,90,6781,1203,7984,0.00269194,-0.0805515,-0.996747
5354,0,0,0,0,3499,99,8952,1885,10837,0.0113359,-0.0689938,-0.997553
3722,0,0,0,0,2552,71,6345,1235,7580,0.0222161,0.00217855,-0.999751
5568,0,0,0,0,3635,102,9305,1828,11133,0.0302191,0.028644,-0.999133
3130,0,0,0,0,1913,55,5098,903,6001,0.0189835,-0.0631515,-0.997823
5602,0,0,0,0,3557,102,9261,2463,11724,0.0568095,-0.0259891,-0.998047
3943,0,0,0,0,2479,72,6494,1063,7557,0.0412638,0.0483323,-0.997979
5604,0,0,0,0,3575,112,9291,1845,11136,0.0174633,-0.0705069,-0.997358
4634,0,0,0,0,2427,62,7123,919,8042,0.034956,-0.0971454,-0.994656
2390,0,0,0,0,1537,43,3970,679,4649,0.0179776,-0.0741754,-0.997083
5800,0,0,0,0,3795,114,9709,873,10582,0.0227803,-0.0845793,-0.996156
4233,0,0,0,0,2677,74,6984,861,7845,0.0145478,-0.0958084,-0.995293
3996,0,0,0,0,2825,81,6902,1166,8068,0.0223384,-0.0740882,-0.997001
4004,0,0,0,0,2808,83,6895,859,7754,0.0217205,-0.0738581,-0.997032
5743,0,0,0,0,4148,126,10017,1197,11214,0.0302197,-0.102367,-0.994288
5760,0,0,0,0,4208,131,10099,1235,11334,0.0229284,-0.0735916,-0.997025
5869,0,0,0,0,4275,83,10227,770,10997,0.0167,-0.0788538,-0.996746
5868,0,0,0,0,4408,123,10399,924,11323,0.00860643,-0.0657708,-0.997798
6021,0,0,0,0,4555,140,10716,1389,12105,0.0155736,-0.0789646,-0.996756
4072,0,0,0,0,3316,89,7477,670,8147,0.0103445,-0.0882559,-0.996044
6038,0,0,0,0,4865,133,11036,1309,12345,0.00264504,-0.0965006,-0.995329
5922,0,0,0,0,5017,138,11077,1143,12220,0.0209263,-0.0886867,-0.99584
5554,0,0,0,0,4797,140,10491,809,11300,0.00578314,-0.0953078,-0.995431
6395,0,0,0,0,5439,109,11943,854,12797,0.0105512,-0.0984577,-0.995085
3241,0,0,0,0,3081,86,6408,508,6916,0.0137882,-0.087908,-0.996033
5388,0,0,0,0,4828,138,10354,863,11217,0.00932088,-0.0840375,-0.996419
6033,0,0,0,0,5978,162,12173,871,13044,0.00686074,-0.121702,-0.992543
3626,0,0,0,0,3240,79,6945,443,7388,0.0183521,-0.127306,-0.991694
2137,0,0,0,0,2264,64,4465,324,4789,-0.000252594,-0.0792819,-0.996852
4324,0,0,0,0,4455,127,8906,617,9523,0.0132224,-0.0607601,-0.998065
6062,0,0,0,0,6629,202,12893,1066,13959,-0.00534311,-0.0825923,-0.996569
6057,0,0,0,0,5860,132,12049,707,12756,0.00341341,-0.100373,-0.994944
3186,0,0,0,0,3013,84,6283,483,6766,0.00205349,-0.0633746,-0.997988
4565,0,0,0,0,5122,142,9829,631,10460,-0.00854935,-0.0676167,-0.997675
6024,0,0,0,0,7075,191,13290,1007,14297,-0.000576151,-0.11505,-0.99336
4222,0,0,0,0,4024,96,8342,757,9099,-0.00478796,-0.0865803,-0.996233
2255,0,0,0,0,2406,53,4714,255,4969,-0.0090578,-0.0761621,-0.997054
5500,0,0,0,0,5879,116,11495,744,12239,-0.00701313,-0.0707372,-0.99747
3948,0,0,0,0,4093,115,8156,518,8674,-0.00349992,-0.049059,-0.99879
6234,0,0,0,0,6524,182,12940,881,13821,-0.00889843,-0.0688623,-0.997586
5879,0,0,0,0,6132,127,12138,754,12892,-0.0273987,-0.0807872,-0.996355
3214,0,0,0,0,3444,91,6749,756,7505,0.00133372,-0.0458039,-0.99895
6908,0,0,0,0,6528,165,13601,1116,14717,-0.0206313,-0.0800208,-0.99658
6066,0,0,0,0,5517,122,11705,645,12350,-0.00408097,-0.0538775,-0.998539
4114,0,0,0,0,5574,121,9809,1017,10826,-0.0254868,-0.0515121,-0.998347
5875,0,0,0,0,5769,165,11809,1517,13326,-0.0163926,-0.10682,-0.994143
5776,0,0,0,0,5441,161,11378,1139,12517,-0.0357033,-0.155876,-0.987131
5306,0,0,0,0,4831,138,10275,1667,11942,-0.0325508,-0.196007,-0.980062
5805,0,0,0,0,4661,145,10611,1124,11735,-0.00348262,-0.00435173,-0.999984
5860,0,0,0,0,5169,148,11177,1415,12592,-0.018921,-0.118788,-0.992739
4074,0,0,0,0,2755,75,6904,864,7768,0.0105936,-0.026475,-0.999593
2448,0,0,0,0,2027,60,4535,468,5003,0.00796222,0.000375858,-0.999968
2790,0,0,0,0,2147,59,4996,886,5882,-0.00132267,0.0119452,-0.999928
5763,0,0,0,0,4570,139,10472,2182,12654,-0.0359835,-0.0707181,-0.996847
5625,0,0,0,0,3637,79,9341,1251,10592,-0.0365035,-0.0693526,-0.996924
4074,0,0,0,0,2653,74,6801,1257,8058,-0.0267998,-0.0475274,-0.99851
6499,0,0,0,0,4082,134,10715,2552,13267,-0.0275118,-0.109815,-0.993571
5661,0,0,0,0,3937,111,9709,1167,10876,-0.0292058,-0.0907295,-0.995447
3889,0,0,0,0,2619,73,6581,1592,8173,-0.0382507,-0.14865,-0.98815
5704,0,0,0,0,3824,109,9637,2953,12590,-0.0454135,-0.154579,-0.986936
3964,0,0,0,0,2528,72,6564,1475,8039,-0.040842,-0.193471,-0.980256
5802,0,0,0,0,3588,118,9508,3269,12777,-0.021736,-0.110847,-0.9936
4607,0,0,0,0,2531,70,7208,2009,9217,-0.0349364,-0.13168,-0.990676
5671,0,0,0,0,3589,103,9363,1781,11144,-0.0481195,-0.140831,-0.988864
5727,0,0,0,0,3567,103,9397,2392,11789,-0.0273353,-0.05401,-0.998166
3985,0,0,0,0,3049,85,7119,2267,9386,-0.0162483,-0.0168847,-0.999725
5567,0,0,0,0,2898,85,8550,2674,11224,-0.0615628,-0.184503,-0.980902
5936,0,0,0,0,3054,92,9082,3906,12988,-0.0608147,-0.177246,-0.982286
5488,0,0,0,0,2796,84,8368,3462,11830,-0.0454389,-0.174375,-0.98363
3809,0,0,0,0,1821,56,5686,2190,7876,-0.0438426,-0.158387,-0.986403
5418,0,0,0,0,2303,71,7792,3127,10919,-0.0605579,-0.0783112,-0.995088
5363,0,0,0,0,2179,68,7610,3845,11455,-0.0827803,-0.103384,-0.991191
3678,0,0,0,0,1394,43,5115,2454,7569,-0.0282078,-0.14854,-0.988504
5402,0,0,0,0,1944,63,7409,3233,10642,-0.0575249,-0.208738,-0.976278
5321,0,0,0,0,1912,63,7296,3782,11078,-0.0184255,-0.307421,-0.951395
3798,0,0,0,0,1213,32,5043,2305,7348,-0.0339809,-0.2209,-0.974704
1879,0,0,0,0,691,21,2591,911,3502,-0.026284,-0.168709,-0.985315
1943,0,0,0,0,706,22,2671,1111,3782,-0.0437721,-0.210302,-0.976656
5547,0,0,0,0,2412,79,8038,2869,10907,-0.0352148,-0.0748549,-0.996572
5728,0,0,0,0,2678,90,8496,2869,11365,-0.0372156,-0.186577,-0.981735
3907,0,0,0,0,1997,65,5969,2745,8714,-0.0491383,-0.188597,-0.980824
5012,0,0,0,0,2812,88,7912,2661,10573,-0.0682289,-0.182166,-0.980898
5678,0,0,0,0,3090,100,8868,2472,11340,-0.0600807,-0.239449,-0.969048
5868,0,0,0,0,3399,73,9340,2396,11736,-0.0250771,-0.184054,-0.982596
3010,0,0,0,0,1953,60,5023,1239,6262,-0.0342822,-0.178728,-0.983301
5754,0,0,0,0,3935,121,9810,4117,13927,-0.090399,-0.124307,-0.988117
4150,0,0,0,0,3038,90,7278,1923,9201,-0.0558748,-0.177189,-0.982589
6012,0,0,0,0,4653,138,10803,2796,13599,-0.05234,-0.18496,-0.981351
6158,0,0,0,0,5102,153,11413,2646,14059,-0.0493828,-0.277366,-0.959494
3181,0,0,0,0,3116,69,6366,1617,7983,-0.0522125,-0.166609,-0.98464
1865,0,0,0,0,1693,46,3604,649,4253,-0.0357689,-0.151915,-0.987746
6180,0,0,0,0,6710,174,13064,3640,16704,-0.0371938,-0.182347,-0.982531
4277,0,0,0,0,4384,121,8782,1704,10486,-0.0907258,-0.160513,-0.982855
3689,0,0,0,0,3955,103,7747,1411,9158,-0.118039,-0.109052,-0.987003
6214,0,0,0,0,6884,183,13281,2478,15759,-0.109434,-0.0897684,-0.989932
4300,0,0,0,0,4880,135,9315,1114,10429,-0.0896482,-0.120884,-0.98861
5713,0,0,0,0,6522,189,12424,1581,14005,-0.0960285,-0.104665,-0.989861
5638,0,0,0,0,6666,195,12499,1104,13603,-0.072781,-0.122961,-0.989739
3991,0,0,0,0,4716,131,8838,953,9791,-0.0594999,-0.117662,-0.99127
6173,0,0,0,0,7105,201,13479,1539,15018,-0.0796082,-0.132443,-0.987989
6178,0,0,0,0,6760,138,13076,694,13770,0.0147296,-0.113059,-0.993479
3916,0,0,0,0,3665,99,7680,627,8307,0.0111442,-0.108503,-0.994034
6133,0,0,0,0,7141,213,13487,1375,14862,0.0026945,-0.129913,-0.991522
4521,0,0,0,0,4529,129,9179,1148,10327,0.0252812,-0.0801386,-0.996463
4229,0,0,0,0,4479,142,8850,1061,9911,0.0272638,-0.128106,-0.991386
6106,0,0,0,0,6024,175,12305,875,13180,0.0087642,-0.112358,-0.993629
3214,0,0,0,0,3335,85,6634,583,7217,0.0103024,-0.127792,-0.991747
5976,0,0,0,0,5861,177,12014,1418,13432,0.0288633,-0.111208,-0.993378
6256,0,0,0,0,5275,155,11686,950,12636,0.033666,-0.107851,-0.993597
5710,0,0,0,0,3316,97,9123,696,9819,0.04272,-0.118056,-0.992088
3165,0,0,0,0,2320,65,5550,809,6359,0.00754555,-0.115357,-0.993295
5757,0,0,0,0,3626,107,9490,1460,10950,0.0253523,-0.101925,-0.994469
5221,0,0,0,0,3077,92,8390,1158,9548,0.0432745,-0.124213,-0.991311
5896,0,0,0,0,3320,105,9321,1457,10778,0.0290115,-0.12214,-0.992089
5693,0,0,0,0,3082,91,8866,1610,10476,0.0265498,-0.126222,-0.991647
4108,0,0,0,0,2132,75,6315,1009,7324,0.043404,-0.115229,-0.99239
3931,0,0,0,0,2274,71,6276,892,7168,0.0258372,-0.11471,-0.993063
5230,0,0,0,0,2941,94,8265,1432,9697,0.0190692,-0.113184,-0.993391
5513,0,0,0,0,3353,98,8964,1226,10190,0.0278924,-0.0918365,-0.995383
3916,0,0,0,0,2217,72,6205,1022,7227,-0.016079,-0.106405,-0.994193
6519,0,0,0,0,3555,117,10191,1134,11325,-0.0281328,-0.0858192,-0.995913
5742,0,0,0,0,3418,125,9285,768,10053,-0.0522689,-0.108326,-0.99274
5174,0,0,0,0,3256,97,8527,804,9331,-0.0493821,-0.0923991,-0.994497
5247,0,0,0,0,3617,101,8965,864,9829,-0.0398646,-0.0783137,-0.996131
5880,0,0,0,0,4381,122,10383,971,11354,-0.0375266,-0.0605216,-0.997461
5687,0,0,0,0,4440,124,10251,1078,11329,-0.00648893,-0.065423,-0.997837
5909,0,0,0,0,4695,128,10732,1240,11972,-0.0348172,-0.0900011,-0.995333
5773,0,0,0,0,3279,92,9144,712,9856,0.0224335,-0.0568564,-0.99813
2136,0,0,0,0,1541,43,3720,403,4123,-0.0231734,-0.0878253,-0.995866
1996,0,0,0,0,1449,40,3485,354,3839,-0.0089868,-0.0699828,-0.997508
6129,0,0,0,0,4108,118,10355,1670,12025,-0.022051,-0.0794089,-0.996598
6162,0,0,0,0,4083,125,10370,934,11304,-0.0784754,-0.126429,-0.988867
3986,0,0,0,0,2728,85,6799,812,7611,-0.00628998,-0.0682825,-0.997646
5865,0,0,0,0,3885,112,9862,974,10836,-0.00279915,-0.0645412,-0.997911
5378,0,0,0,0,3328,112,8818,1185,10003,-0.0254938,-0.0885887,-0.995742
3722,0,0,0,0,2446,71,6239,673,6912,-0.0245447,-0.0933672,-0.995329
5995,0,0,0,0,3953,113,10061,846,10907,-0.0300807,-0.0872896,-0.995729
3886,0,0,0,0,2648,81,6615,791,7406,-0.0277797,-0.086764,-0.995842
5656,0,0,0,0,3927,122,9705,1067,10772,-0.0242135,-0.0715359,-0.997144
5680,0,0,0,0,4001,104,9785,1071,10856,-0.0346078,-0.0827897,-0.995966
3694,0,0,0,0,2540,72,6306,708,7014,-0.0166813,-0.0648987,-0.997752
5214,0,0,0,0,3419,105,8738,1187,9925,-0.0379244,-0.0528911,-0.99788
4862,0,0,0,0,3351,105,8318,843,9161,-0.0366727,-0.0785018,-0.996239
3427,0,0,0,0,2472,70,5969,727,6696,-0.0639989,-0.100214,-0.992906
5815,0,0,0,0,4398,137,10350,1334,11684,-0.0660486,-0.0979112,-0.993001
5816,0,0,0,0,4384,124,10324,964,11288,-0.0728878,-0.101534,-0.992158
3974,0,0,0,0,3239,96,7309,777,8086,-0.0892133,-0.101496,-0.990828
5886,0,0,0,0,4942,136,10964,880,11844,-0.0615966,-0.108719,-0.992162
5208,0,0,0,0,4642,128,9978,776,10754,-0.0250806,-0.0698516,-0.997242
5883,0,0,0,0,5401,146,11430,850,12280,-0.0613193,-0.0922193,-0.993849
3199,0,0,0,0,2693,74,5966,395,6361,-0.0816277,-0.0900232,-0.992589
2354,0,0,0,0,2069,60,4483,382,4865,-0.0501568,-0.0696636,-0.996309
5487,0,0,0,0,5267,143,10897,875,11772,-0.0632146,-0.0840115,-0.994458
5446,0,0,0,0,5271,152,10869,942,11811,-0.0501229,-0.0673359,-0.996471
3947,0,0,0,0,3943,110,8000,635,8635,-0.0634345,-0.0817365,-0.994633
6162,0,0,0,0,6135,175,12472,937,13409,-0.0776477,-0.0922399,-0.992705
6068,0,0,0,0,4367,99,10534,540,11074,-0.0493777,-0.0695722,-0.996354
2585,0,0,0,0,2671,76,5332,350,5682,-0.049423,-0.0693707,-0.996366
5309,0,0,0,0,5738,170,11217,799,12016,-0.0819746,-0.0774311,-0.993622
5399,0,0,0,0,5701,165,11265,670,11935,-0.0443328,-0.0675434,-0.996731
3754,0,0,0,0,4027,107,7888,593,8481,-0.0486078,-0.0662471,-0.996619
5455,0,0,0,0,5860,167,11482,584,12066,-0.0665006,-0.0642107,-0.995718
3757,0,0,0,0,3932,106,7795,630,8425,-0.0521186,-0.0618601,-0.996723
5836,0,0,0,0,6229,151,12216,1000,13216,-0.0822362,-0.0630946,-0.994614
3998,0,0,0,0,4350,124,8472,640,9112,-0.0635346,-0.0656606,-0.995817
4195,0,0,0,0,4368,116,8679,895,9574,-0.0684945,-0.0645965,-0.995558
5924,0,0,0,0,6356,154,12434,916,13350,-0.0682146,-0.0365532,-0.997001
5388,0,0,0,0,5376,119,10883,560,11443,-0.0833991,-0.0577706,-0.99484
3426,0,0,0,0,3352,88,6866,648,7514,-0.0574638,-0.0535628,-0.99691
5819,0,0,0,0,6633,218,12670,1010,13680,-0.0671935,-0.080742,-0.994468
4245,0,0,0,0,4380,116,8741,1150,9891,-0.0875071,-0.0476851,-0.995022
5946,0,0,0,0,6401,180,12527,1046,13573,-0.0315984,-0.05307,-0.998091
4141,0,0,0,0,4288,116,8545,855,9400,-0.0702155,-0.0520928,-0.996171
6008,0,0,0,0,5951,170,12129,1447,13576,-0.112884,-0.0693827,-0.991183
4163,0,0,0,0,4209,112,8484,1152,9636,-0.0628926,-0.0491955,-0.996807
5958,0,0,0,0,6193,180,12331,1567,13898,-0.119439,-0.0886279,-0.988878
5382,0,0,0,0,5736,166,11284,1102,12386,-0.0339847,-0.0428616,-0.998503
4998,0,0,0,0,4938,143,10079,1286,11365,-0.0854729,-0.128594,-0.988007
5388,0,0,0,0,5396,167,10951,1824,12775,-0.114454,-0.113344,-0.986942
3967,0,0,0,0,3772,99,7838,1271,9109,-0.0892378,-0.0699587,-0.99355
5210,0,0,0,0,5139,144,10493,1303,11796,-0.104865,-0.0766888,-0.991525
5573,0,0,0,0,5365,151,11089,1242,12331,-0.169097,-0.101346,-0.980375
5329,0,0,0,0,4875,129,10333,823,11156,-0.201252,-0.0966171,-0.974763
3660,0,0,0,0,3357,95,7112,679,7791,-0.0592803,-0.0412136,-0.99739
5759,0,0,0,0,5347,152,11258,1661,12919,-0.0984691,-0.072495,-0.992496
3971,0,0,0,0,3561,102,7634,761,8395,-0.0963749,-0.0399689,-0.994542
5606,0,0,0,0,5122,150,10878,1106,11984,-0.0574873,0.00524818,-0.998332
5251,0,0,0,0,4811,135,10197,700,10897,-0.0419837,-0.0102025,-0.999066
3939,0,0,0,0,3285,96,7320,650,7970,-0.0394889,-0.00536543,-0.999206
5833,0,0,0,0,4685,132,10650,787,11437,-0.0362031,-0.0166697,-0.999205
5268,0,0,0,0,4596,134,9998,569,10567,-0.0332659,0.00490819,-0.999434
3808,0,0,0,0,3156,93,7057,669,7726,-0.0360905,0.00958284,-0.999303
4830,0,0,0,0,3818,113,8761,724,9485,-0.0897504,-0.0222081,-0.995717
5273,0,0,0,0,4091,125,9489,1322,10811,-0.0707258,0.0064094,-0.997475
5765,0,0,0,0,3987,120,9872,1440,11312,-0.136704,-0.0593785,-0.988831
3710,0,0,0,0,2567,70,6347,639,6986,-0.071236,-0.00431909,-0.99745
4818,0,0,0,0,3157,100,8075,1350,9425,-0.0549245,0.0119775,-0.998419
4747,0,0,0,0,3220,101,8068,1104,9172,-0.073172,-0.0308943,-0.996841
4736,0,0,0,0,2821,89,7646,1234,8880,-0.0826,-0.00633982,-0.996563
4612,0,0,0,0,2666,87,7365,1821,9186,-0.0485893,-0.00254496,-0.998816
4644,0,0,0,0,2811,86,7541,1419,8960,-0.0964939,-0.028457,-0.994927
4662,0,0,0,0,2611,83,7356,1366,8722,-0.106635,-0.0286273,-0.993886
4641,0,0,0,0,2491,82,7214,1242,8456,-0.0906802,-0.0118566,-0.995809
5357,0,0,0,0,2432,78,7867,1331,9198,-0.0805572,-0.0339186,-0.996173
4645,0,0,0,0,2284,81,7010,1167,8177,-0.0624379,-0.0224539,-0.997796
4110,0,0,0,0,1655,57,5822,965,6787,-0.095107,-0.0408054,-0.99463
4884,0,0,0,0,2548,87,7519,1548,9067,-0.0795477,-0.0315764,-0.996331
5663,0,0,0,0,2818,94,8575,2223,10798,-0.0994752,-0.061621,-0.99313
5000,0,0,0,0,2487,74,7561,2372,9933,-0.0663587,-0.0308926,-0.997317
5004,0,0,0,0,2485,71,7560,1518,9078,-0.0747409,-0.0535661,-0.995763
5033,0,0,0,0,2325,70,7428,2228,9656,-0.0700479,-0.0474403,-0.996415
4909,0,0,0,0,2164,68,7141,1973,9114,-0.10924,-0.0874477,-0.990161
4913,0,0,0,0,2215,68,7196,1797,8993,-0.0921033,-0.0621778,-0.993806
4981,0,0,0,0,2146,68,7195,2295,9490,-0.16546,-0.117411,-0.979203
5517,0,0,0,0,2399,76,7992,2053,10045,-0.110374,-0.120649,-0.98654
5610,0,0,0,0,2331,74,8015,2140,10155,-0.101394,-0.0810809,-0.991537
5064,0,0,0,0,1724,53,6841,1050,7891,-0.130926,-0.0856809,-0.987683
2350,0,0,0,0,1094,33,3477,780,4257,-0.0689356,-0.0576339,-0.995955
2644,0,0,0,0,1289,38,3971,624,4595,-0.0908213,-0.0603382,-0.994038
5104,0,0,0,0,2601,78,7783,1581,9364,-0.124328,-0.0908863,-0.98807
5092,0,0,0,0,2099,57,7248,918,8166,-0.157862,-0.108012,-0.981536
2762,0,0,0,0,1448,38,4248,773,5021,-0.170175,-0.139146,-0.97554
2631,0,0,0,0,1549,44,4224,745,4969,-0.188993,-0.135731,-0.972553
5833,0,0,0,0,3354,96,9283,3500,12783,-0.193128,-0.157678,-0.968421
3523,0,0,0,0,1761,56,5340,1451,6791,-0.215641,-0.191567,-0.957497
2068,0,0,0,0,1241,42,3351,1395,4746,-0.0898145,-0.0689435,-0.993569
5371,0,0,0,0,3341,102,8814,2194,11008,-0.143135,-0.121023,-0.982276
5350,0,0,0,0,3561,109,9020,5114,14134,-0.21071,-0.210007,-0.954724
2875,0,0,0,0,2108,63,5046,2688,7734,-0.285557,-0.290694,-0.913211
5345,0,0,0,0,4624,124,10093,3766,13859,-0.33938,-0.329511,-0.881047
5932,0,0,0,0,5572,134,11638,5291,16929,-0.385289,-0.403919,-0.8297
3176,0,0,0,0,3243,88,6507,5166,11673,-0.388936,-0.448767,-0.804572
5559,0,0,0,0,5683,145,11387,9854,21241,-0.355556,-0.406116,-0.841814
5749,0,0,0,0,5536,151,11436,7215,18651,-0.452783,-0.48759,-0.746488
2989,0,0,0,0,3135,87,6211,3897,10108,-0.486049,-0.589224,-0.645424
4449,0,0,0,0,4671,131,9251,5275,14526,-0.546305,-0.625994,-0.55649
4463,0,0,0,0,4420,118,9001,7753,16754,-0.477172,-0.656234,-0.584521
5962,0,0,0,0,6172,163,12297,6144,18441,-0.426386,-0.62963,-0.649431
3109,0,0,0,0,3697,100,6906,4016,10922,-0.399224,-0.602456,-0.691135
5876,0,0,0,0,5862,110,11848,5189,17037,-0.351062,-0.576446,-0.737879
2549,0,0,0,0,2889,82,5520,2473,7993,-0.367231,-0.570315,-0.734767
4446,0,0,0,0,4424,116,8986,4532,13518,-0.34655,-0.534705,-0.77071
6256,0,0,0,0,5531,146,11933,3389,15322,-0.396456,-0.529312,-0.750101
4054,0,0,0,0,3431,91,7576,4332,11908,-0.476699,-0.576821,-0.663352
3248,0,0,0,0,2428,68,5744,2789,8533,-0.468569,-0.61301,-0.63613
5488,0,0,0,0,3722,104,9314,6643,15957,-0.49604,-0.728286,-0.472804
3726,0,0,0,0,2365,67,6158,4760,10918,-0.502952,-0.768982,-0.394596
5234,0,0,0,0,3343,93,8670,10137,18807,-0.486554,-0.76067,-0.429705
2884,0,0,0,0,1720,49,4653,1604,6257,-0.486514,-0.794297,-0.363864
5801,0,0,0,0,2993,88,8882,-1,-1,-1,-1,-1
2262,0,0,0,0,1013,30,3305,406,3711,-0.0734337,-0.111189,-0.991082
4997,0,0,0,0,2333,75,7405,807,8212,-0.11833,-0.116893,-0.98607
5067,0,0,0,0,2268,70,7405,818,8223,-0.0802176,-0.0960559,-0.992138
5132,0,0,0,0,2265,74,7471,1009,8480,-0.0675501,-0.0811994,-0.994406
4499,0,0,0,0,1814,65,6378,1032,7410,-0.0523305,-0.0677348,-0.99633
4470,0,0,0,0,1660,57,6187,1715,7902,-0.0675977,-0.0592663,-0.995951
4450,0,0,0,0,1757,55,6262,853,7115,-0.0688019,-0.0713257,-0.995077
5686,0,0,0,0,2198,93,7977,1256,9233,-0.0608175,-0.0941053,-0.993703
5526,0,0,0,0,2249,73,7848,1265,9113,-0.0735311,-0.0692792,-0.994884
4270,0,0,0,0,1399,45,5714,710,6424,-0.0600145,-0.0699585,-0.995743
2880,0,0,0,0,1050,33,3963,800,4763,-0.0242733,-0.0480164,-0.998552
5350,0,0,0,0,1874,60,7284,2088,9372,-0.0599822,-0.0888595,-0.994236
5479,0,0,0,0,2124,75,7678,1413,9091,-0.0711806,-0.0841175,-0.99391
5374,0,0,0,0,2093,72,7539,1880,9419,-0.04602,-0.0713951,-0.996386
5440,0,0,0,0,2240,81,7761,2721,10482,-0.0251702,0.000620109,-0.999683
5404,0,0,0,0,1968,64,7436,2316,9752,-0.0254211,-0.0551331,-0.998155
5432,0,0,0,0,2046,67,7545,1801,9346,-0.0415112,-0.0160879,-0.999009
3678,0,0,0,0,1343,44,5065,862,5927,-0.0682578,-0.0813893,-0.994342
5500,0,0,0,0,2048,68,7616,1507,9123,-0.0759355,-0.0684943,-0.994757
5467,0,0,0,0,2332,73,7872,2141,10013,-0.0296271,-0.0424922,-0.998657
5069,0,0,0,0,2823,88,7980,1713,9693,-0.0158525,-0.0768476,-0.996917
5323,0,0,0,0,2414,86,7823,1406,9229,-0.0323038,-0.0780029,-0.99643
4960,0,0,0,0,2499,83,7542,1851,9393,0.0125541,-0.0716588,-0.99735
4878,0,0,0,0,2456,83,7417,1876,9293,0.0307284,-0.153613,-0.987653
5457,0,0,0,0,2785,84,8326,2821,11147,0.0040421,-0.105978,-0.99436
3750,0,0,0,0,1897,67,5714,1409,7123,0.0353001,-0.0866047,-0.995617
5578,0,0,0,0,2795,93,8466,2233,10699,0.0132672,-0.0962145,-0.995272
5611,0,0,0,0,2806,96,8513,2079,10592,0.0337732,-0.127629,-0.991247
5510,0,0,0,0,2848,88,8446,1632,10078,0.0543856,-0.0985213,-0.993648
5658,0,0,0,0,2993,88,8739,1625,10364,0.0387428,-0.0858829,-0.995552
4935,0,0,0,0,3130,95,8160,1280,9440,0.040277,-0.100359,-0.994136
4886,0,0,0,0,2863,86,7835,1297,9132,0.0377284,-0.081877,-0.995928
5003,0,0,0,0,2968,86,8057,1070,9127,0.0486919,-0.0782825,-0.995741
4961,0,0,0,0,3045,87,8093,923,9016,0.0473475,-0.105975,-0.993241
5143,0,0,0,0,3023,92,8258,1310,9568,0.0359076,-0.113003,-0.992946
5079,0,0,0,0,3218,94,8391,1388,9779,0.0685947,-0.0917835,-0.993414
5801,0,0,0,0,3809,122,9732,1080,10812,0.0436377,-0.131339,-0.990377
5105,0,0,0,0,3811,72,8988,508,9496,0.0549412,-0.124139,-0.990743
2456,0,0,0,0,1758,53,4267,467,4734,0.0270607,-0.0919452,-0.995396
6597,0,0,0,0,4426,126,11149,1067,12216,0.0441322,-0.103653,-0.993634
5787,0,0,0,0,4615,137,10539,1163,11702,0.0347858,-0.0920394,-0.995148
3977,0,0,0,0,3291,93,7361,659,8020,0.0299842,-0.0871627,-0.995743
5242,0,0,0,0,4471,152,9865,950,10815,0.0334595,-0.0917456,-0.99522
5910,0,0,0,0,5360,149,11419,926,12345,-0.000674886,-0.0896549,-0.995973
5896,0,0,0,0,5607,153,11656,926,12582,-0.0263775,-0.121568,-0.992233
4097,0,0,0,0,3341,89,7527,485,8012,0.000791344,-0.0770198,-0.997029
2516,0,0,0,0,2575,60,5151,317,5468,0.00814935,-0.0654991,-0.997819
4159,0,0,0,0,4483,127,8769,572,9341,-0.01319,-0.0597529,-0.998126
6303,0,0,0,0,6079,174,12556,821,13377,-0.00362119,-0.0591304,-0.998244
3817,0,0,0,0,4527,121,8465,595,9060,0.0211948,-0.0497371,-0.998537
6052,0,0,0,0,7208,179,13439,833,14272,-0.00477023,-0.061702,-0.998083
3838,0,0,0,0,4728,126,8692,801,9493,0.00797238,-0.0983638,-0.995119
6016,0,0,0,0,7593,209,13818,1109,14927,-0.0162114,-0.0634074,-0.997856
4178,0,0,0,0,5398,168,9744,833,10577,-0.022997,-0.0831755,-0.99627
5944,0,0,0,0,7425,194,13563,967,14530,-0.014051,-0.092799,-0.995586
4145,0,0,0,0,4905,139,9189,1392,10581,0.0365195,-0.0921302,-0.995077
5527,0,0,0,0,6106,169,11802,6166,17968,0.357172,-0.125277,-0.925599
3846,0,0,0,0,4092,111,8049,2870,10919,0.451584,-0.114371,-0.884868
3446,0,0,0,0,3416,90,6952,-1,-1,-1,-1,-1
3222,0,0,0,0,2792,78,6092,464,6556,-0.0102525,-0.0243659,-0.999651
5230,0,0,0,0,4055,117,9402,809,10211,-0.0124889,-0.0605092,-0.99809
5077,0,0,0,0,3636,98,8811,1264,10075,-0.0256638,-0.0642037,-0.997607
5102,0,0,0,0,3227,94,8423,998,9421,-0.00426103,-0.01183,-0.999921
5617,0,0,0,0,3150,95,8862,781,9643,-0.0374492,-0.0942666,-0.994842
3344,0,0,0,0,1569,46,4959,605,5564,-0.0373734,-0.0282116,-0.998903
1976,0,0,0,0,961,29,2966,328,3294,-0.033716,-0.0346654,-0.99883
5560,0,0,0,0,2592,78,8230,1022,9252,-0.0324578,-0.0470583,-0.998365
5394,0,0,0,0,2377,82,7853,1004,8857,-0.0262511,-0.0289315,-0.999237
5358,0,0,0,0,2197,69,7624,1429,9053,-0.0520361,-0.0558246,-0.997084
5331,0,0,0,0,2101,66,7498,1085,8583,-0.0889407,-0.135015,-0.986844
3455,0,0,0,0,1033,34,4522,795,5317,-0.0574012,-0.0980371,-0.993526
2292,0,0,0,0,761,27,3080,545,3625,-0.0397979,-0.0449537,-0.998196
2941,0,0,0,0,1016,33,3990,737,4727,-0.054327,-0.0746463,-0.995729
5468,0,0,0,0,1737,58,7263,1673,8936,-0.0581778,-0.0705092,-0.995813
5300,0,0,0,0,1687,65,7052,1179,8231,-0.0670921,-0.0917563,-0.993519
5186,0,0,0,0,1580,55,6821,1724,8545,-0.0345653,-0.0399943,-0.998602
5174,0,0,0,0,1532,54,6760,1351,8111,-0.0333168,-0.0737921,-0.996717
5130,0,0,0,0,1488,54,6672,1308,7980,-0.0423598,-0.111367,-0.992876
5168,0,0,0,0,1449,51,6668,996,7664,-0.0227169,-0.0838424,-0.99622
5167,0,0,0,0,1394,50,6611,978,7589,-0.0180693,-0.0858056,-0.996148
5151,0,0,0,0,1250,47,6448,1043,7491,-0.019,-0.0922942,-0.99555
5173,0,0,0,0,1749,59,6981,1398,8379,-0.0238846,-0.0839243,-0.996186
5248,0,0,0,0,1165,42,6455,601,7056,-0.0250866,-0.0776789,-0.996663
3642,0,0,0,0,908,40,4590,568,5158,-0.0263595,-0.106884,-0.993922
4882,0,0,0,0,1295,49,6226,905,7131,-0.0104135,-0.151291,-0.988434
5252,0,0,0,0,1392,52,6696,737,7433,-0.0231362,-0.106734,-0.994018
5715,0,0,0,0,1600,63,7378,1039,8417,-0.00937194,-0.15658,-0.987621
5720,0,0,0,0,2205,75,8000,1030,9030,-0.0016045,-0.131515,-0.991313
3705,0,0,0,0,1334,45,5084,835,5919,-0.00577027,-0.121596,-0.992563
5315,0,0,0,0,2150,68,7533,827,8360,0.00155585,-0.137158,-0.990548
5455,0,0,0,0,2203,72,7730,935,8665,0.0226983,-0.155312,-0.987605
5805,0,0,0,0,2408,73,8286,1298,9584,0.0223166,-0.154903,-0.987678
3836,0,0,0,0,1807,64,5707,876,6583,0.00983647,-0.138225,-0.990352
3832,0,0,0,0,1954,64,5850,703,6553,-0.00976045,-0.127073,-0.991845
4611,0,0,0,0,2307,71,6989,1629,8618,0.00579302,-0.158051,-0.987414
4088,0,0,0,0,2554,72,6714,1276,7990,-0.00474403,-0.206153,-0.978508
5173,0,0,0,0,3864,116,9153,6267,15420,0.0065817,-0.167352,-0.985875
2984,0,0,0,0,2355,64,5403,3222,8625,-0.0125948,-0.17977,-0.983628
5142,0,0,0,0,4617,145,9904,5119,15023,0.0690656,-0.189784,-0.979394
3725,0,0,0,0,3648,98,7471,2573,10044,0.0964491,-0.139247,-0.985549
3798,0,0,0,0,3882,105,7785,1857,9642,0.0744236,-0.151936,-0.985584
4781,0,0,0,0,5470,150,10401,2583,12984,0.142796,-0.22112,-0.964736
4748,0,0,0,0,4773,129,9650,6615,16265,0.124213,-0.234151,-0.964233
3511,0,0,0,0,3339,93,6943,3192,10135,-0.00878159,-0.276927,-0.960851
5898,0,0,0,0,5216,182,11296,4113,15409,-0.0590712,-0.332128,-0.941383
4001,0,0,0,0,3215,89,7305,897,8202,0.0289432,-0.186114,-0.982102
5197,0,0,0,0,4050,143,9390,903,10293,0.0320678,-0.16663,-0.985498
5276,0,0,0,0,3224,112,8612,809,9421,0.048569,-0.165075,-0.985084
5974,0,0,0,0,2693,90,8757,493,9250,0.0524584,-0.149638,-0.987348
3519,0,0,0,0,1602,48,5169,524,5693,0.0779555,-0.147654,-0.985962
5578,0,0,0,0,2388,112,8078,877,8955,0.0450265,-0.162516,-0.985678
5555,0,0,0,0,2071,70,7696,878,8574,0.0507852,-0.172702,-0.983664
5482,0,0,0,0,1997,79,7558,1074,8632,0.0377944,-0.131636,-0.990577
3709,0,0,0,0,1344,43,5096,541,5637,0.0409378,-0.132451,-0.990344
4836,0,0,0,0,1557,55,6448,704,7152,0.0280197,-0.121222,-0.99223
4984,0,0,0,0,1985,57,7026,830,7856,0.0306569,-0.130959,-0.990914
5392,0,0,0,0,1502,54,6948,840,7788,0.046438,-0.176565,-0.983193
3609,0,0,0,0,979,28,4616,454,5070,0.0290071,-0.156689,-0.987222
2258,0,0,0,0,655,23,2936,392,3328,0.0399041,-0.132519,-0.990377
4226,0,0,0,0,1290,44,5560,664,6224,0.0437665,-0.12593,-0.991073
5559,0,0,0,0,1981,64,7604,830,8434,0.0426264,-0.136317,-0.989748
5463,0,0,0,0,2368,85,7916,1104,9020,0.0365468,-0.133877,-0.990324
3686,0,0,0,0,1467,45,5198,722,5920,0.0304011,-0.124492,-0.991755
5271,0,0,0,0,2103,66,7440,1126,8566,0.0326378,-0.143969,-0.989044
4127,0,0,0,0,1473,45,5645,818,6463,0.0226099,-0.114363,-0.993182
2256,0,0,0,0,937,33,3226,464,3690,0.0296975,-0.107122,-0.993802
4996,0,0,0,0,1966,66,7028,1214,8242,0.0283241,-0.109341,-0.993601
4697,0,0,0,0,1934,62,6693,1411,8104,0.024307,-0.05837,-0.997999
5506,0,0,0,0,2351,85,7942,1398,9340,0.0136009,-0.0817044,-0.996564
5411,0,0,0,0,2180,78,7669,1364,9033,0.00289451,-0.140213,-0.990117
4113,0,0,0,0,1508,54,5675,535,6210,-0.0065285,-0.125494,-0.992073
2764,0,0,0,0,1191,37,3992,1055,5047,0.00193126,-0.0968883,-0.995293
2232,0,0,0,0,981,31,3244,759,4003,0.0214169,-0.0879538,-0.995894
5352,0,0,0,0,2669,81,8102,951,9053,0.0146999,-0.0855359,-0.996227
5238,0,0,0,0,2340,54,7632,838,8470,-0.00652036,-0.067958,-0.997667
3036,0,0,0,0,1315,45,4396,667,5063,0.0289314,-0.0530037,-0.998175
4905,0,0,0,0,2646,93,7644,1324,8968,0.00899705,-0.0997381,-0.994973
5540,0,0,0,0,2568,88,8196,1681,9877,0.0185978,-0.0890292,-0.995855
5271,0,0,0,0,2425,83,7779,753,8532,0.0104494,-0.09356,-0.995559
3579,0,0,0,0,1721,55,5355,615,5970,0.0134784,-0.0866648,-0.996146
5393,0,0,0,0,2901,86,8380,1208,9588,0.0134003,-0.0972682,-0.995168
5535,0,0,0,0,2780,87,8402,795,9197,0.0181824,-0.099412,-0.99488
5385,0,0,0,0,2839,88,8312,1054,9366,0.00742898,-0.149221,-0.988776
4066,0,0,0,0,2143,48,6257,510,6767,0.000285574,-0.134338,-0.990935
2418,0,0,0,0,1309,39,3766,400,4166,0.0273076,-0.0922961,-0.995357
5391,0,0,0,0,3711,115,9217,760,9977,0.0057889,-0.0957288,-0.995391
5318,0,0,0,0,3300,90,8708,759,9467,0.00808134,-0.109113,-0.993997
5570,0,0,0,0,3770,107,9447,754,10201,0.010669,-0.108274,-0.994064
5618,0,0,0,0,3552,106,9276,834,10110,0.0149802,-0.103588,-0.994507
3768,0,0,0,0,2659,76,6503,539,7042,0.00746226,-0.0725162,-0.997339
4985,0,0,0,0,3544,113,8642,641,9283,0.0351964,-0.101972,-0.994164
5256,0,0,0,0,3712,110,9078,822,9900,0.017984,-0.0983444,-0.99499
5181,0,0,0,0,2739,79,7999,470,8469,0.020126,-0.0917346,-0.99558
3448,0,0,0,0,2782,89,6319,519,6838,0.0409033,-0.0968145,-0.994462
5112,0,0,0,0,4156,122,9390,750,10140,0.0211002,-0.0891649,-0.995793
5122,0,0,0,0,4560,127,9809,755,10564,0.0116955,-0.102845,-0.994629
5723,0,0,0,0,5322,145,11190,794,11984,0.00518666,-0.0981571,-0.995157
5788,0,0,0,0,5051,161,11000,535,11535,-0.0116269,-0.0972961,-0.995188
3985,0,0,0,0,3463,99,7547,678,8225,-0.00085714,-0.075411,-0.997152
5772,0,0,0,0,4351,129,10252,586,10838,0.0230506,-0.0836234,-0.996231
3024,0,0,0,0,2275,64,5363,454,5817,-0.000922473,-0.0903467,-0.99591
5858,0,0,0,0,4027,116,10001,838,10839,0.000495178,-0.0768643,-0.997041
5720,0,0,0,0,3831,110,9661,855,10516,0.00977256,-0.138454,-0.990321
5729,0,0,0,0,2671,73,8473,544,9017,-0.00216739,-0.104125,-0.994562
2284,0,0,0,0,1483,40,3807,315,4122,-0.00904567,-0.0583737,-0.998254
5082,0,0,0,0,2798,103,7983,667,8650,-0.0256589,-0.0651997,-0.997542
4906,0,0,0,0,2744,90,7740,690,8430,-0.00248814,-0.0279628,-0.999606
4818,0,0,0,0,2526,75,7419,700,8119,-0.0221404,-0.0141126,-0.999655
4999,0,0,0,0,2491,76,7566,675,8241,-0.0230567,-0.00429826,-0.999725
5401,0,0,0,0,2741,86,8228,797,9025,-0.0468663,0.023841,-0.998617
4733,0,0,0,0,1938,59,6730,460,7190,-0.0382872,0.0441087,-0.998293
2291,0,0,0,0,1039,32,3362,260,3622,-0.0275522,0.0350745,-0.999005
2786,0,0,0,0,1615,48,4449,372,4821,-0.0126487,0.0424461,-0.999019
5525,0,0,0,0,3334,108,8967,685,9652,-0.0358739,0.0612361,-0.997478
5504,0,0,0,0,3765,118,9387,663,10050,-0.0189762,0.083631,-0.996316
5527,0,0,0,0,4056,119,9702,678,10380,-0.0298952,0.0861452,-0.995834
5615,0,0,0,0,4277,134,10026,793,10819,-0.0280662,0.0975024,-0.994839
3814,0,0,0,0,3086,106,7006,500,7506,-0.0149151,0.108289,-0.994008
