Downsample[ns],BuildFilTree[ns],SearchFil[ns],DeleteFil[ns],BuildTreeSub[ns],SearchSub[ns],DeleteSub[ns],PreProcTotal[ns],Plane[ns],Total[ns],nx,ny,nz
6828,0,0,0,0,7672,171,14671,3936,18607,0.0109767,-0.0361171,-0.999287
2522,0,0,0,0,3451,68,6041,3179,9220,0.0334507,-0.0343868,-0.998849
3300,0,0,0,0,4191,88,7579,3612,11191,0.0189206,-0.0313907,-0.999328
2344,0,0,0,0,3032,83,5459,2687,8146,-0.00180495,-0.0161741,-0.999868
2551,0,0,0,0,3258,90,5899,3115,9014,-0.0254385,0.000883867,-0.999676
2651,0,0,0,0,3375,88,6114,2648,8762,-0.026968,-0.00558383,-0.999621
2677,0,0,0,0,3272,96,6045,3081,9126,-0.049241,0.0357208,-0.998148
2738,0,0,0,0,3584,98,6420,2585,9005,-0.0978,-0.00713022,-0.995181
2521,0,0,0,0,3218,90,5829,2922,8751,-0.0806982,-0.00503689,-0.996726
2118,0,0,0,0,2679,73,4870,2327,7197,-0.080813,0.00771149,-0.996699
2696,0,0,0,0,3412,92,6200,2951,9151,-0.0870416,-0.0132002,-0.996117
3467,0,0,0,0,4751,127,8345,4020,12365,-0.0653633,-0.00688486,-0.997838
6601,0,0,0,0,8608,188,15397,3343,18740,-0.0793196,0.00952637,-0.996804
2113,0,0,0,0,2753,82,4948,2173,7121,-0.0770649,0.0107671,-0.996968
2073,0,0,0,0,3262,77,5412,2156,7568,-0.0133785,-0.0276187,-0.999529
2645,0,0,0,0,3018,79,5742,2929,8671,-0.0294047,-7.33656e-07,-0.999568
1791,0,0,0,0,2310,64,4165,1790,5955,-0.0974956,-0.00559012,-0.99522
1491,0,0,0,0,2058,73,3622,1637,5259,-0.0662817,-0.000501356,-0.997801
1692,0,0,0,0,2091,87,3870,2100,5970,-0.0668906,0.0244578,-0.997461
1857,0,0,0,0,2135,81,4073,1920,5993,-0.0212197,-0.0131319,-0.999689
1659,0,0,0,0,1983,73,3715,1725,5440,-0.0431428,-0.0168035,-0.998928
1502,0,0,0,0,2061,76,3639,1629,5268,-0.0343418,-0.00597347,-0.999392
1517,0,0,0,0,2084,79,3680,1799,5479,-0.0716412,0.00477549,-0.997419
1530,0,0,0,0,2168,62,3760,1802,5562,-0.0916671,0.00117044,-0.995789
1497,0,0,0,0,1984,71,3552,1686,5238,-0.0183478,-0.0339869,-0.999254
1571,0,0,0,0,2185,78,3834,1796,5630,-0.0218913,-0.0477292,-0.99862
1674,0,0,0,0,2058,79,3811,1996,5807,-0.0676136,-0.111091,-0.991508
1571,0,0,0,0,2090,70,3731,1610,5341,-0.0180924,-0.0431815,-0.998903
1649,0,0,0,0,1896,76,3621,1722,5343,-0.0576323,-0.0473588,-0.997214
1628,0,0,0,0,2045,79,3752,1731,5483,-0.029824,-0.0413336,-0.9987
1584,0,0,0,0,1911,77,3572,2224,5796,-0.0835502,-0.0041919,-0.996495
1732,0,0,0,0,2205,59,3996,1634,5630,-0.019745,-0.0411233,-0.998959
1495,0,0,0,0,2073,80,3648,2184,5832,-0.0615298,-0.0335102,-0.997543
1590,0,0,0,0,2159,90,3839,1830,5669,-0.0704382,-0.0377917,-0.9968
1466,0,0,0,0,2022,75,3563,1833,5396,-0.0943248,0.0017297,-0.99554
1552,0,0,0,0,2004,83,3639,1625,5264,-0.0715174,0.0330507,-0.996892
1468,0,0,0,0,2196,81,3745,1573,5318,-0.0111077,-0.0276418,-0.999556
1523,0,0,0,0,2258,91,3872,1929,5801,-0.0561355,-0.00611808,-0.998404
1617,0,0,0,0,1932,77,3626,1657,5283,-0.0203686,-0.00733824,-0.999766
1503,0,0,0,0,1948,77,3528,1730,5258,-0.0391082,0.00818787,-0.999201
1676,0,0,0,0,2002,103,3781,1583,5364,-0.0895869,-0.0101061,-0.995928
1669,0,0,0,0,1937,51,3657,1627,5284,-0.00865866,-0.0264599,-0.999612
1832,0,0,0,0,2339,66,4237,2331,6568,-0.0431622,0.00471709,-0.999057
2273,0,0,0,0,3730,83,6086,2684,8770,-0.0177123,-0.0148422,-0.999733
3243,0,0,0,0,4534,116,7893,4417,12310,-0.0516281,-0.0102787,-0.998613
3511,0,0,0,0,4840,120,8471,4403,12874,-0.0498631,-0.0122669,-0.998681
3259,0,0,0,0,4246,110,7615,3966,11581,-0.0579671,-0.0133063,-0.99823
3663,0,0,0,0,5041,125,8829,4361,13190,-0.042145,-0.00529976,-0.999097
3754,0,0,0,0,5022,135,8911,3876,12787,-0.0612904,-0.00213888,-0.998118
2490,0,0,0,0,3257,89,5836,2757,8593,-0.0774577,0.01633,-0.996862
5420,0,0,0,0,7919,146,13485,3509,16994,-0.0923552,0.0312721,-0.995235
2183,0,0,0,0,2925,83,5191,2503,7694,-0.100769,0.020855,-0.994691
5927,0,0,0,0,7568,189,13684,3657,17341,-0.102279,0.025688,-0.994424
3085,0,0,0,0,2706,72,5863,1985,7848,-0.0561302,0.0111308,-0.998361
2230,0,0,0,0,2295,64,4589,2084,6673,-0.0476527,0.00846669,-0.998828
2231,0,0,0,0,2771,76,5078,2397,7475,-0.0595493,0.0295637,-0.997787
3960,0,0,0,0,5374,128,9462,4369,13831,-0.00599742,-0.0325711,-0.999451
3130,0,0,0,0,3877,106,7113,3745,10858,-0.0304986,-0.00707434,-0.99951
2980,0,0,0,0,3887,108,6975,4002,10977,-0.0394523,0.00075552,-0.999221
2944,0,0,0,0,3846,102,6892,3496,10388,-0.0420385,0.00474813,-0.999105
3261,0,0,0,0,3911,100,7272,4454,11726,-0.073207,0.0195674,-0.997125
2274,0,0,0,0,2761,77,5112,2317,7429,-0.0750337,0.0157318,-0.997057
7115,0,0,0,0,7035,133,14283,3305,17588,-0.0168615,-0.0237947,-0.999575
6884,0,0,0,0,9343,229,16456,4370,20826,-0.0461133,-0.0117597,-0.998867
2199,0,0,0,0,2665,73,4937,2076,7013,-0.0628412,0.00207116,-0.998021
2035,0,0,0,0,2304,64,4403,2184,6587,-0.0906913,0.0140858,-0.995779
5997,0,0,0,0,7369,144,13510,3299,16809,-0.0894536,0.00326111,-0.995986
6586,0,0,0,0,8387,148,15121,3819,18940,-0.11146,0.041098,-0.992919
2301,0,0,0,0,2806,63,5170,2396,7566,-0.104084,-0.00150152,-0.994567
1924,0,0,0,0,1966,51,3941,1583,5524,-0.0831208,0.0322731,-0.996017
1471,0,0,0,0,1793,45,3309,1787,5096,-0.0879319,-0.0135722,-0.996034
2279,0,0,0,0,3247,86,5612,3374,8986,-0.0731138,-0.000777308,-0.997323
3517,0,0,0,0,4268,115,7900,4200,12100,-0.0838448,-0.0124254,-0.996401
3771,0,0,0,0,4310,109,8190,3952,12142,-0.0664948,0.0115886,-0.997719
6018,0,0,0,0,6472,129,12619,3143,15762,-0.0142197,-0.0258941,-0.999564
2219,0,0,0,0,2687,72,4978,2847,7825,-0.0318353,-0.0546276,-0.997999
6635,0,0,0,0,7775,194,14604,4058,18662,-0.0792765,-0.0654616,-0.994701
2436,0,0,0,0,2656,70,5162,2316,7478,0.0180296,-0.0205104,-0.999627
1694,0,0,0,0,1770,45,3509,1966,5475,0.021843,-0.061894,-0.997844
1606,0,0,0,0,1794,48,3448,1867,5315,0.0515358,-0.0884316,-0.994748
2682,0,0,0,0,2890,75,5647,2998,8645,0.00516665,-0.0420867,-0.999101
3957,0,0,0,0,3911,106,7974,4986,12960,0.0131328,-0.0634317,-0.9979
2830,0,0,0,0,2814,75,5719,3830,9549,-0.00422527,-0.0980445,-0.995173
4541,0,0,0,0,4486,118,9145,4008,13153,0.0198169,-0.0382159,-0.999073
2586,0,0,0,0,2784,72,5442,3502,8944,-0.0120014,-0.0263321,-0.999581
2538,0,0,0,0,2691,72,5301,3747,9048,-0.0189096,-0.0826018,-0.996403
6354,0,0,0,0,6914,221,13489,5256,18745,0.0342075,-0.0517587,-0.998074
1916,0,0,0,0,2097,61,4074,2241,6315,0.0378929,-0.10237,-0.994024
1926,0,0,0,0,2147,59,4132,2308,6440,0.000182092,-0.0440369,-0.99903
3374,0,0,0,0,3287,94,6755,4317,11072,-0.0170517,-0.0828043,-0.99642
2920,0,0,0,0,3747,103,6770,3171,9941,0.0139778,-0.0414281,-0.999044
2395,0,0,0,0,2643,70,5108,3626,8734,0.0373331,-0.0699564,-0.996851
6595,0,0,0,0,7064,154,13813,3532,17345,0.0395161,-0.0448485,-0.998212
2279,0,0,0,0,2493,67,4839,3550,8389,0.0403089,-0.132286,-0.990392
1921,0,0,0,0,1998,57,3976,2223,6199,-0.00179588,-0.0821475,-0.996619
3769,0,0,0,0,3965,118,7852,4468,12320,-0.025816,-0.0833127,-0.996189
3742,0,0,0,0,4036,127,7905,3345,11250,-0.0256755,-0.0339157,-0.999095
2045,0,0,0,0,2050,54,4149,2845,6994,-0.054301,-0.0612077,-0.996647
6362,0,0,0,0,6637,168,13167,3730,16897,-0.0313267,-0.0123299,-0.999433
2217,0,0,0,0,2363,60,4640,2622,7262,-0.0435464,-0.0207788,-0.998835
1834,0,0,0,0,1959,50,3843,2449,6292,-0.0503387,-0.0364167,-0.998068
3064,0,0,0,0,3439,92,6595,4703,11298,-0.0757567,-0.0399973,-0.996324
3135,0,0,0,0,3494,99,6728,5010,11738,-0.112231,-0.0851557,-0.990027
1404,0,0,0,0,1723,42,3169,2149,5318,-0.128495,-0.100602,-0.986594
1521,0,0,0,0,1490,39,3050,1642,4692,-0.00843301,-0.0300382,-0.999513
2757,0,0,0,0,3260,86,6103,3952,10055,0.0140547,0.0262915,-0.999556
2917,0,0,0,0,3131,81,6129,3505,9634,-0.00358647,0.0123612,-0.999917
2340,0,0,0,0,2544,65,4949,3278,8227,-0.017617,-0.0183863,-0.999676
2366,0,0,0,0,2541,64,4971,3355,8326,-0.00607172,0.0454178,-0.99895
3039,0,0,0,0,3349,97,6485,3637,10122,-0.0201673,0.0737372,-0.997074
2997,0,0,0,0,3189,84,6270,4081,10351,-0.0300488,0.0648835,-0.99744
6576,0,0,0,0,6546,172,13294,5224,18518,-0.0588187,0.0773018,-0.995271
2160,0,0,0,0,2342,66,4568,2971,7539,-0.0193829,-0.0324165,-0.999286
2370,0,0,0,0,2856,72,5298,3559,8857,-0.0765159,-0.0116938,-0.997
2749,0,0,0,0,2975,76,5800,3885,9685,-0.106301,0.0093451,-0.99429
6639,0,0,0,0,6698,182,13519,4052,17571,0.00803154,-0.0345955,-0.999369
2649,0,0,0,0,2447,99,5195,2727,7922,-0.00616396,-0.0474104,-0.998856
1466,0,0,0,0,1578,40,3084,1907,4991,0.00762448,-0.127185,-0.99185
1443,0,0,0,0,1556,44,3043,1624,4667,0.00934316,-0.047004,-0.998851
2373,0,0,0,0,2534,74,4981,3544,8525,0.0211633,-0.144612,-0.989262
6090,0,0,0,0,6569,195,12854,3662,16516,0.0129972,-0.0272002,-0.999546
2619,0,0,0,0,2740,71,5430,4184,9614,0.0326144,-0.0212238,-0.999243
2454,0,0,0,0,2634,68,5156,2848,8004,0.0242574,-0.0328765,-0.999165
4253,0,0,0,0,4520,127,8900,4544,13444,0.028668,-0.0584402,-0.997879
3177,0,0,0,0,3368,90,6635,3613,10248,0.0115955,-0.0690508,-0.997546
3028,0,0,0,0,3132,83,6243,3607,9850,0.0124603,-0.0727508,-0.997272
3063,0,0,0,0,3072,81,6216,3392,9608,0.0097343,-0.071587,-0.997387
2604,0,0,0,0,2532,78,5214,2758,7972,-0.001555,-0.0630327,-0.99801
2552,0,0,0,0,2317,67,4936,2919,7855,-0.0163845,-0.0685959,-0.99751
2453,0,0,0,0,2302,66,4821,3875,8696,-0.00415016,-0.0689837,-0.997609
2442,0,0,0,0,2254,69,4765,2797,7562,-0.00291384,-0.0561009,-0.998421
2478,0,0,0,0,2127,58,4663,3136,7799,0.00154243,-0.0647365,-0.997901
2464,0,0,0,0,1872,51,4387,2949,7336,0.00447459,-0.0743538,-0.997222
2414,0,0,0,0,1810,62,4286,2965,7251,-0.00395748,-0.0708719,-0.997478
2545,0,0,0,0,1999,54,4598,2876,7474,0.000178309,-0.0485774,-0.998819
2648,0,0,0,0,2115,65,4828,2840,7668,0.0185568,-0.0599081,-0.998031
3391,0,0,0,0,2682,73,6146,4149,10295,0.00819295,-0.0892392,-0.995977
3570,0,0,0,0,2485,94,6149,4037,10186,-0.00234483,-0.0817207,-0.996653
3794,0,0,0,0,2717,75,6586,4271,10857,-0.0123274,-0.0677326,-0.997627
3007,0,0,0,0,1993,78,5078,3421,8499,-0.0139752,-0.0776854,-0.99688
2024,0,0,0,0,1372,39,3435,2662,6097,-0.0233394,-0.0754045,-0.99688
3769,0,0,0,0,2588,84,6441,4774,11215,-0.0130655,-0.122895,-0.992334
3978,0,0,0,0,2547,84,6609,4626,11235,0.027098,-0.0837883,-0.996115
3673,0,0,0,0,2446,84,6203,3894,10097,0.0243947,-0.0626963,-0.997734
5603,0,0,0,0,3634,104,9341,4808,14149,0.0134027,-0.133413,-0.99097
2476,0,0,0,0,1535,44,4055,2586,6641,0.0178423,-0.0898722,-0.995793
1692,0,0,0,0,985,29,2706,1905,4611,0.0166378,-0.0783116,-0.99679
1213,0,0,0,0,867,22,2102,1570,3672,0.0392911,-0.0347681,-0.998623
2132,0,0,0,0,1385,41,3558,3093,6651,0.0254199,-0.0734868,-0.996972
6341,0,0,0,0,3637,117,10095,4630,14725,0.0317833,-0.0752064,-0.996661
2308,0,0,0,0,1517,45,3870,2626,6496,0.024451,-0.0353248,-0.999077
2976,0,0,0,0,1992,57,5025,3797,8822,0.0086017,-0.0769655,-0.996997
4623,0,0,0,0,3148,99,7870,5308,13178,0.00596051,-0.000983742,-0.999982
2630,0,0,0,0,1780,50,4460,3540,8000,0.0178943,0.0455539,-0.998802
3579,0,0,0,0,2448,70,6097,4753,10850,-0.0146861,-0.0278652,-0.999504
3665,0,0,0,0,2555,70,6290,4146,10436,0.00357649,-0.0332759,-0.99944
2866,0,0,0,0,1936,54,4856,3808,8664,0.00749608,-0.052755,-0.998579
3714,0,0,0,0,2479,73,6266,4603,10869,-0.00124521,-0.0925978,-0.995703
3475,0,0,0,0,2595,73,6143,4235,10378,-0.0132839,-0.0511763,-0.998601
3243,0,0,0,0,2496,70,5809,4227,10036,-0.0198969,-0.0706345,-0.997304
3951,0,0,0,0,3176,86,7213,4619,11832,-0.00704442,-0.0612462,-0.998098
3078,0,0,0,0,2411,70,5559,4220,9779,0.00657924,-0.0492387,-0.998765
3072,0,0,0,0,2419,70,5561,4126,9687,0.0281484,-0.0230948,-0.999337
5900,0,0,0,0,4609,142,10651,4140,14791,0.0239587,-0.0697836,-0.997274
2465,0,0,0,0,1912,58,4435,2521,6956,0.00671187,-0.0950324,-0.995452
5998,0,0,0,0,4685,140,10823,4765,15588,0.0182529,-0.005848,-0.999816
2070,0,0,0,0,1623,49,3742,2602,6344,0.0103171,-0.0683183,-0.99761
5762,0,0,0,0,4403,139,10304,4714,15018,0.0302754,-0.149796,-0.988253
2526,0,0,0,0,1870,55,4451,2427,6878,0.011001,-0.0842605,-0.996383
1928,0,0,0,0,1449,42,3419,2771,6190,0.0119242,-0.0830219,-0.996476
5772,0,0,0,0,4182,126,10080,5921,16001,0.0055242,-0.10322,-0.994643
2998,0,0,0,0,2176,65,5239,3063,8302,0.0107504,-0.08288,-0.996502
2025,0,0,0,0,1425,43,3493,2602,6095,0.0234948,-0.0655404,-0.997573
3904,0,0,0,0,2736,82,6722,4926,11648,0.000814005,-0.106102,-0.994355
4081,0,0,0,0,2010,61,6152,3774,9926,0.0219352,-0.114785,-0.993148
4166,0,0,0,0,1887,53,6106,3748,9854,0.00961246,-0.118624,-0.992893
4209,0,0,0,0,2923,79,7211,5281,12492,0.0199329,-0.0155199,-0.999681
2523,0,0,0,0,1592,47,4162,3999,8161,0.00525218,-0.117164,-0.993099
5782,0,0,0,0,3859,115,9756,4253,14009,0.0075912,-0.0854285,-0.996315
2430,0,0,0,0,1513,42,3985,2588,6573,0.023471,-0.0452434,-0.9987
3156,0,0,0,0,2461,70,5687,3949,9636,0.0183201,-0.0621565,-0.997898
5015,0,0,0,0,3642,87,8744,3942,12686,0.0162749,-0.0979338,-0.99506
2511,0,0,0,0,1602,45,4158,3065,7223,0.0153112,-0.0985251,-0.995017
4429,0,0,0,0,2883,80,7392,4278,11670,0.0301616,-0.125574,-0.991626
2699,0,0,0,0,1797,48,4544,3286,7830,0.0151452,-0.0745303,-0.997104
2605,0,0,0,0,1773,52,4430,3153,7583,0.0219545,-0.0921139,-0.995506
3698,0,0,0,0,2505,69,6272,4480,10752,0.0420191,-0.0942121,-0.994665
2972,0,0,0,0,2023,56,5051,3571,8622,0.0279811,-0.0713602,-0.997058
2976,0,0,0,0,2474,66,5516,4251,9767,0.0192124,-0.0833987,-0.996331
5515,0,0,0,0,4037,109,9661,4426,14087,0.0170006,-0.0866811,-0.996091
2576,0,0,0,0,1868,51,4495,2917,7412,0.0335333,-0.0533472,-0.998013
2840,0,0,0,0,2110,78,5028,3181,8209,0.0198306,-0.091336,-0.995623
3799,0,0,0,0,3101,95,6995,4173,11168,-0.000143238,-0.0438624,-0.999038
2603,0,0,0,0,2047,54,4704,2966,7670,0.00437655,-0.0743208,-0.997225
3055,0,0,0,0,2716,73,5844,3864,9708,-0.0103985,-0.133683,-0.99097
3163,0,0,0,0,2806,76,6045,3911,9956,0.0164171,-0.0871276,-0.996062
2699,0,0,0,0,2477,68,5244,2985,8229,0.020849,-0.0780013,-0.996735
4681,0,0,0,0,4577,119,9377,4756,14133,0.00320989,-0.0958886,-0.995387
6180,0,0,0,0,6266,163,12609,3940,16549,0.00132604,-0.134984,-0.990847
2665,0,0,0,0,2318,58,5041,2230,7271,-0.000619011,-0.157735,-0.987481
1681,0,0,0,0,1788,42,3511,1658,5169,0.000590158,-0.0705282,-0.99751
1342,0,0,0,0,1467,38,2847,1462,4309,0.00561108,-0.0730079,-0.997316
6768,0,0,0,0,6797,202,13767,4009,17776,-0.00943891,-0.0899151,-0.995905
2525,0,0,0,0,2928,65,5518,2256,7774,-0.00156825,-0.0760258,-0.997105
2233,0,0,0,0,2580,68,4881,2564,7445,-0.00175699,-0.0637918,-0.997962
3574,0,0,0,0,4143,120,7837,4011,11848,0.000750785,-0.0712555,-0.997458
6177,0,0,0,0,6887,181,13245,4577,17822,-0.0152311,-0.132729,-0.991035
2627,0,0,0,0,2740,62,5429,2189,7618,0.0137339,-0.0859876,-0.996202
1712,0,0,0,0,1802,49,3563,1718,5281,-0.0145572,-0.0670126,-0.997646
1322,0,0,0,0,1419,39,2780,1641,4421,0.00205626,-0.0389466,-0.999239
6304,0,0,0,0,6724,181,13209,3749,16958,-0.0172817,-0.0644895,-0.997769
2215,0,0,0,0,2284,65,4564,3654,8218,0.011128,-0.0527744,-0.998544
2442,0,0,0,0,2624,74,5140,3276,8416,-0.00582436,-0.0748629,-0.997177
2841,0,0,0,0,3039,84,5964,4058,10022,-0.024564,-0.0669851,-0.997452
3205,0,0,0,0,3652,117,6974,4082,11056,-0.0362005,-0.0872444,-0.995529
3496,0,0,0,0,3577,92,7165,3949,11114,-0.0372357,-0.0663694,-0.9971
2759,0,0,0,0,2777,72,5608,3155,8763,-0.0529949,-0.096892,-0.993883
2751,0,0,0,0,2662,68,5481,3594,9075,-0.0357994,-0.115601,-0.99265
2752,0,0,0,0,2553,66,5371,3424,8795,-0.0314507,-0.182679,-0.982669
3177,0,0,0,0,2954,90,6221,3956,10177,-0.0322274,-0.214448,-0.976204
3164,0,0,0,0,2790,73,6027,3717,9744,0.00230044,-0.0212834,-0.999771
6002,0,0,0,0,5212,157,11371,4795,16166,-0.0161441,-0.124525,-0.992085
2521,0,0,0,0,2220,47,4788,2402,7190,-0.010072,-0.103052,-0.994625
1627,0,0,0,0,1325,35,2987,1751,4738,0.00177078,-0.0414156,-0.99914
6097,0,0,0,0,4347,87,10531,3630,14161,-0.0220436,-0.012964,-0.999673
6023,0,0,0,0,3233,96,9352,3791,13143,-0.0222374,-0.0743661,-0.996983
2599,0,0,0,0,1945,46,4590,2107,6697,0.00830931,-0.0431509,-0.999034
1544,0,0,0,0,1130,45,2719,2029,4748,-0.0437452,-0.0484732,-0.997866
5086,0,0,0,0,2927,72,8085,3587,11672,-0.0307579,-0.108683,-0.993601
1565,0,0,0,0,1083,38,2686,2245,4931,-0.0345705,-0.0916417,-0.995192
5669,0,0,0,0,2799,76,8544,3493,12037,-0.0239202,-0.192126,-0.981079
1802,0,0,0,0,1241,34,3077,2565,5642,-0.0183102,-0.0779628,-0.996788
5981,0,0,0,0,3804,117,9902,4467,14369,-0.0303433,-0.173492,-0.984368
2526,0,0,0,0,1307,38,3871,2657,6528,-0.0307925,-0.120447,-0.992242
2227,0,0,0,0,1435,40,3702,3573,7275,-0.0124509,-0.0581558,-0.99823
3626,0,0,0,0,2289,64,5979,6103,12082,-0.0298932,0.0091807,-0.999511
2817,0,0,0,0,1796,64,4677,4257,8934,-0.0245555,-0.0571948,-0.998061
5725,0,0,0,0,3497,105,9327,4598,13925,-0.0443982,-0.108848,-0.993066
2214,0,0,0,0,1163,34,3411,2831,6242,-0.0375555,-0.141921,-0.989165
5776,0,0,0,0,3127,97,9000,5399,14399,-0.0672609,-0.222045,-0.972714
1983,0,0,0,0,986,30,2999,3061,6060,-0.0575637,-0.143455,-0.987981
2531,0,0,0,0,1199,35,3765,4309,8074,-0.0515923,-0.164866,-0.984966
4477,0,0,0,0,2052,62,6591,5810,12401,-0.0689217,-0.361609,-0.929779
2222,0,0,0,0,845,28,3095,3795,6890,-0.0703333,-0.269393,-0.960459
3385,0,0,0,0,1314,41,4740,6300,11040,-0.0492462,-0.160061,-0.985878
4349,0,0,0,0,1636,52,6037,5621,11658,-0.057545,-0.16533,-0.984558
5458,0,0,0,0,1889,61,7408,5461,12869,-0.0187099,-0.274411,-0.961431
2236,0,0,0,0,778,26,3040,2935,5975,-0.0290535,-0.200716,-0.979219
1373,0,0,0,0,446,14,1833,1901,3734,-0.0309261,-0.170578,-0.984859
1226,0,0,0,0,481,15,1722,1981,3703,-0.00979401,-0.227594,-0.973707
5560,0,0,0,0,2392,72,8024,6128,14152,-0.0269937,-0.223418,-0.974349
2366,0,0,0,0,1115,35,3516,4160,7676,-0.0275515,-0.182694,-0.982784
5653,0,0,0,0,2796,83,8532,5987,14519,-0.0481203,-0.206662,-0.977228
2388,0,0,0,0,1246,36,3670,4145,7815,-0.0252767,-0.224506,-0.974145
3125,0,0,0,0,1747,51,4923,4965,9888,-0.0211754,-0.235606,-0.971618
5059,0,0,0,0,3064,87,8210,5524,13734,-0.0547536,-0.227481,-0.972242
2369,0,0,0,0,1552,48,3969,4385,8354,-0.0759066,-0.254299,-0.964142
3238,0,0,0,0,2223,68,5529,5822,11351,-0.0702228,-0.192677,-0.978746
4328,0,0,0,0,2998,90,7416,4881,12297,-0.0719291,-0.204584,-0.976203
3160,0,0,0,0,2511,72,5743,4289,10032,-0.0926631,-0.172397,-0.980659
5948,0,0,0,0,5251,138,11337,5018,16355,-0.0191812,-0.219452,-0.975435
2610,0,0,0,0,2153,63,4826,3491,8317,-0.0933496,-0.145832,-0.984895
1485,0,0,0,0,1375,58,2918,1857,4775,-0.0298878,-0.139728,-0.989739
1538,0,0,0,0,1505,43,3086,2426,5512,-0.0956963,-0.123921,-0.987667
3226,0,0,0,0,3253,91,6570,4589,11159,-0.125403,-0.13312,-0.983134
5215,0,0,0,0,5590,151,10956,3734,14690,-0.0164284,-0.154361,-0.987878
2503,0,0,0,0,2747,76,5326,4073,9399,-0.0575062,-0.149755,-0.987049
2757,0,0,0,0,2971,83,5811,3576,9387,-0.0817807,-0.109224,-0.990647
4344,0,0,0,0,4319,122,8785,4862,13647,-0.047128,-0.135911,-0.9896
3677,0,0,0,0,4290,120,8087,4360,12447,-0.0772471,-0.149372,-0.985759
2413,0,0,0,0,2787,77,5277,2950,8227,-0.0882811,-0.15516,-0.983937
4011,0,0,0,0,4657,128,8796,4596,13392,-0.0950005,-0.12661,-0.987393
3078,0,0,0,0,3483,100,6661,3598,10259,-0.0107326,-0.124354,-0.99218
3276,0,0,0,0,3335,88,6699,3539,10238,0.0130995,-0.108978,-0.993958
3418,0,0,0,0,3770,105,7293,4386,11679,0.00992398,-0.137922,-0.990393
3262,0,0,0,0,3410,97,6769,4025,10794,0.0276124,-0.116216,-0.99284
3991,0,0,0,0,3971,115,8077,4225,12302,0.0105568,-0.110335,-0.993838
3091,0,0,0,0,2974,85,6150,3520,9670,0.0179716,-0.111749,-0.993574
4549,0,0,0,0,4359,127,9035,4005,13040,0.010755,-0.14086,-0.989971
2694,0,0,0,0,2467,72,5233,3158,8391,0.0185642,-0.113379,-0.993378
3293,0,0,0,0,2774,89,6156,3724,9880,-0.001211,-0.142695,-0.989766
3196,0,0,0,0,2706,79,5981,3879,9860,0.00935109,-0.114607,-0.993367
3113,0,0,0,0,2300,70,5483,3703,9186,0.0210816,-0.117037,-0.992904
5914,0,0,0,0,4060,162,10136,3833,13969,0.043544,-0.13371,-0.990063
2089,0,0,0,0,1237,35,3361,2906,6267,0.0246478,-0.114969,-0.993063
3228,0,0,0,0,1756,52,5036,4147,9183,0.0129611,-0.11594,-0.993172
4179,0,0,0,0,2016,61,6256,4962,11218,0.00545552,-0.106137,-0.994337
5973,0,0,0,0,2966,95,9034,4019,13053,-0.0296674,-0.15713,-0.987132
2031,0,0,0,0,1096,32,3159,2766,5925,0.0438635,-0.0818881,-0.995676
3159,0,0,0,0,1801,53,5013,4406,9419,0.0487927,-0.101196,-0.993669
5761,0,0,0,0,3384,104,9249,4252,13501,0.0204447,-0.109075,-0.993823
2836,0,0,0,0,1760,50,4646,2652,7298,0.0031686,-0.101477,-0.994833
5886,0,0,0,0,3504,110,9500,3500,13000,-0.054172,-0.107521,-0.992726
2575,0,0,0,0,1247,49,3871,2622,6493,-0.0347155,-0.0591649,-0.997644
2688,0,0,0,0,1703,49,4440,3388,7828,-0.0441134,-0.08464,-0.995435
5277,0,0,0,0,3666,103,9046,4350,13396,-0.0808142,-0.106757,-0.990995
2433,0,0,0,0,1770,53,4256,2571,6827,-0.0373517,-0.0756735,-0.996433
5965,0,0,0,0,4626,159,10750,3413,14163,-0.0412178,-0.0818824,-0.995789
7117,0,0,0,0,4619,141,11877,4422,16299,-0.0460502,-0.116274,-0.992149
2565,0,0,0,0,1914,55,4534,2284,6818,-0.0136916,-0.0968656,-0.995203
1603,0,0,0,0,1170,33,2806,1711,4517,0.00399039,-0.0631692,-0.997995
7015,0,0,0,0,4477,136,11628,3789,15417,0.0152955,-0.0484641,-0.998708
2139,0,0,0,0,1478,46,3663,2576,6239,-0.00405373,-0.0691581,-0.997597
4089,0,0,0,0,2861,85,7035,4638,11673,-0.00685583,-0.0777186,-0.996952
3062,0,0,0,0,2111,59,5232,3706,8938,0.0123097,-0.0603504,-0.998101
2620,0,0,0,0,1609,51,4280,3064,7344,-0.00702401,-0.0961018,-0.995347
6154,0,0,0,0,3772,114,10040,3583,13623,-0.0215359,-0.085126,-0.996137
2045,0,0,0,0,1346,38,3429,2643,6072,-0.0141973,-0.0827163,-0.996472
3244,0,0,0,0,2157,60,5461,4196,9657,0.00889625,-0.0491249,-0.998753
3454,0,0,0,0,2206,73,5733,4044,9777,-0.0272194,-0.0895074,-0.995614
6149,0,0,0,0,3504,79,9732,3350,13082,-0.049402,-0.0948548,-0.994265
2053,0,0,0,0,1426,51,3530,2597,6127,-0.0159909,-0.0702437,-0.997402
5824,0,0,0,0,4068,118,10010,3710,13720,-0.0462299,-0.0725988,-0.996289
2481,0,0,0,0,1732,50,4263,2966,7229,-0.0393877,-0.0797371,-0.996037
2843,0,0,0,0,2130,59,5032,3400,8432,-0.054188,-0.0979001,-0.99372
3232,0,0,0,0,2061,63,5356,3430,8786,-0.047169,-0.0879822,-0.995005
2577,0,0,0,0,2053,61,4691,3412,8103,-0.0517202,-0.0831163,-0.995197
5417,0,0,0,0,4038,119,9574,4300,13874,-0.0526672,-0.0977126,-0.99382
2343,0,0,0,0,1931,57,4331,2793,7124,-0.0807248,-0.108568,-0.990806
2639,0,0,0,0,2220,65,4924,3120,8044,-0.063949,-0.0864516,-0.994202
4814,0,0,0,0,5155,119,10088,4912,15000,-0.0771248,-0.0751778,-0.994183
3809,0,0,0,0,3239,100,7148,4262,11410,-0.0599992,-0.0907453,-0.994065
2874,0,0,0,0,2695,77,5646,3223,8869,-0.0680773,-0.0806336,-0.994416
2870,0,0,0,0,3424,81,6375,3184,9559,-0.0180783,-0.0590646,-0.99809
2819,0,0,0,0,2733,75,5627,3277,8904,-0.041479,-0.067686,-0.996844
3348,0,0,0,0,3332,95,6775,3783,10558,-0.0325268,-0.092539,-0.995178
3442,0,0,0,0,3409,101,6952,3305,10257,-0.0552969,-0.0804832,-0.995221
6582,0,0,0,0,4383,122,11087,3046,14133,-0.0704747,-0.108576,-0.991587
1875,0,0,0,0,1898,51,3824,2153,5977,-0.0886131,-0.0919581,-0.991812
3159,0,0,0,0,3290,87,6536,3567,10103,-0.0574198,-0.0698723,-0.995902
5033,0,0,0,0,5301,156,10490,4053,14543,-0.0651033,-0.0752314,-0.995039
2896,0,0,0,0,3036,81,6013,3032,9045,-0.054835,-0.0676611,-0.9962
1947,0,0,0,0,2070,60,4077,2253,6330,-0.0439126,-0.0676412,-0.996743
3486,0,0,0,0,3970,110,7566,4105,11671,-0.0625731,-0.0743611,-0.995266
3510,0,0,0,0,3779,108,7397,3338,10735,-0.0824795,-0.0759874,-0.993692
6039,0,0,0,0,6220,178,12437,4136,16573,-0.0850507,-0.0595544,-0.994595
2447,0,0,0,0,2666,72,5185,2696,7881,-0.0944206,-0.0736671,-0.992803
2844,0,0,0,0,2964,91,5899,3179,9078,-0.0677138,-0.0632195,-0.9957
5968,0,0,0,0,6308,181,12457,3675,16132,-0.0755756,-0.0679422,-0.994823
2139,0,0,0,0,2267,64,4470,2478,6948,-0.0544342,-0.0659428,-0.996338
2066,0,0,0,0,2189,57,4312,2452,6764,-0.0643835,-0.060241,-0.996105
3841,0,0,0,0,4325,111,8277,4659,12936,-0.0780221,-0.0691684,-0.994549
3920,0,0,0,0,4111,111,8142,3455,11597,-0.0691943,-0.0602157,-0.995784
2089,0,0,0,0,2092,61,4242,2537,6779,-0.0670089,-0.0735292,-0.995039
3893,0,0,0,0,4030,116,8039,5320,13359,-0.109572,-0.0369273,-0.993293
3198,0,0,0,0,3056,85,6339,3319,9658,-0.0630357,-0.0413966,-0.997152
2696,0,0,0,0,2540,76,5312,3022,8334,-0.0253741,-0.0449517,-0.998667
4191,0,0,0,0,4431,114,8736,3690,12426,-0.0548912,-0.0725481,-0.995853
2617,0,0,0,0,2724,71,5412,3173,8585,-0.087611,-0.085784,-0.992454
3198,0,0,0,0,3064,83,6345,3568,9913,-0.13184,-0.108953,-0.985265
3633,0,0,0,0,3583,100,7316,4610,11926,-0.197389,-0.115028,-0.973553
2800,0,0,0,0,2773,75,5648,3755,9403,-0.217552,-0.149505,-0.964531
3302,0,0,0,0,3143,87,6532,4120,10652,-0.189903,-0.107366,-0.975915
3266,0,0,0,0,2996,95,6357,3694,10051,-0.22618,-0.133052,-0.964956
2617,0,0,0,0,2444,65,5126,3468,8594,-0.231868,-0.112326,-0.96624
4188,0,0,0,0,3611,97,7896,4064,11960,-0.0740066,-0.0279937,-0.996865
2440,0,0,0,0,2145,57,4642,2944,7586,-0.0542084,-0.0209708,-0.998309
2453,0,0,0,0,2111,58,4622,3017,7639,-0.0520573,-0.0080448,-0.998612
2482,0,0,0,0,2151,56,4689,3016,7705,-0.0538248,-0.0142173,-0.998449
3356,0,0,0,0,2912,77,6345,4054,10399,-0.0414255,-0.00831599,-0.999107
6370,0,0,0,0,5436,145,11951,3917,15868,-0.0566499,-0.0112089,-0.998331
5889,0,0,0,0,5178,165,11232,4237,15469,-0.0376,-0.0165721,-0.999155
2559,0,0,0,0,2167,60,4786,2321,7107,-0.0262263,-0.0188974,-0.999477
6094,0,0,0,0,5122,171,11387,7204,18591,-0.0483899,-0.0121562,-0.998755
5917,0,0,0,0,3255,89,9261,2942,12203,-0.080091,-0.0228865,-0.996525
5957,0,0,0,0,3705,85,9747,2986,12733,-0.0695815,-0.0114346,-0.997511
1779,0,0,0,0,1293,36,3108,2317,5425,-0.0726274,0.00481499,-0.997348
3026,0,0,0,0,2096,60,5182,3762,8944,-0.0989926,-0.0325654,-0.994555
4730,0,0,0,0,3196,91,8017,4286,12303,-0.0735836,0.00461912,-0.997278
2665,0,0,0,0,1759,50,4474,3259,7733,-0.0618283,-0.00832311,-0.998052
2234,0,0,0,0,1373,40,3647,3074,6721,-0.103666,0.000643896,-0.994612
5789,0,0,0,0,4117,105,10011,4565,14576,-0.0934012,-0.0299951,-0.995177
2401,0,0,0,0,1401,40,3842,3464,7306,-0.0839371,-0.00134272,-0.99647
3515,0,0,0,0,1943,63,5521,4472,9993,-0.109108,-0.0188212,-0.993852
3377,0,0,0,0,1858,56,5291,4437,9728,-0.0788113,-0.00433988,-0.99688
2669,0,0,0,0,1461,50,4180,3341,7521,-0.0775734,-0.0532296,-0.995565
2134,0,0,0,0,1072,32,3238,2728,5966,-0.0600687,-0.0317922,-0.997688
4678,0,0,0,0,2360,70,7108,5129,12237,-0.0777441,-0.0382614,-0.996239
2643,0,0,0,0,1331,40,4014,3667,7681,-0.0670186,-0.0269204,-0.997388
3048,0,0,0,0,1608,47,4703,4541,9244,-0.120376,-0.0850322,-0.98908
5002,0,0,0,0,2470,88,7560,4612,12172,-0.05845,-0.0712926,-0.995741
2193,0,0,0,0,1034,32,3259,3073,6332,-0.10208,-0.0707139,-0.99226
3051,0,0,0,0,1413,44,4508,4469,8977,-0.108694,-0.0560361,-0.992495
3084,0,0,0,0,1441,47,4572,4367,8939,-0.046592,-0.0397194,-0.998124
5555,0,0,0,0,2461,76,8092,4316,12408,-0.0675004,-0.0577936,-0.996044
1981,0,0,0,0,848,30,2859,2838,5697,-0.0697716,-0.0146212,-0.997456
2860,0,0,0,0,1260,39,4159,4284,8443,-0.11563,-0.109237,-0.987267
5729,0,0,0,0,2459,76,8264,4642,12906,-0.145806,-0.107799,-0.983423
2330,0,0,0,0,1047,32,3409,2659,6068,-0.0990581,-0.0596483,-0.993292
1546,0,0,0,0,678,21,2245,1781,4026,-0.105139,-0.0815052,-0.991112
5691,0,0,0,0,2919,95,8705,5271,13976,-0.0562942,-0.0927102,-0.9941
5672,0,0,0,0,3030,98,8800,4513,13313,-0.0422241,-0.0934697,-0.994726
2412,0,0,0,0,1204,35,3651,2245,5896,-0.0423444,-0.0575927,-0.997442
1374,0,0,0,0,769,26,2169,1719,3888,-0.0949165,-0.0813388,-0.992157
1348,0,0,0,0,787,26,2161,1828,3989,-0.0673727,-0.0570362,-0.996096
2959,0,0,0,0,1826,57,4842,3990,8832,-0.129068,-0.104411,-0.986124
2957,0,0,0,0,1759,52,4768,3121,7889,-0.140322,-0.103486,-0.984683
1829,0,0,0,0,1071,31,2931,2624,5555,-0.144848,-0.116878,-0.982527
2248,0,0,0,0,1216,35,3499,3702,7201,-0.214776,-0.206475,-0.954588
3412,0,0,0,0,2356,66,5834,6851,12685,-0.240605,-0.277173,-0.930207
3537,0,0,0,0,2582,70,6189,6149,12338,-0.259963,-0.325402,-0.909138
6097,0,0,0,0,4271,106,10474,5127,15601,-0.22145,-0.291326,-0.930639
1853,0,0,0,0,1733,48,3634,3230,6864,-0.2355,-0.34574,-0.908297
6238,0,0,0,0,5897,170,12305,6181,18486,-0.290616,-0.428679,-0.855439
2175,0,0,0,0,2197,61,4433,3751,8184,-0.21462,-0.334904,-0.917484
1813,0,0,0,0,1933,52,3798,3466,7264,-0.245074,-0.362342,-0.899248
3009,0,0,0,0,3409,91,6509,5753,12262,-0.274944,-0.400537,-0.874057
3094,0,0,0,0,3148,84,6326,6867,13193,-0.320203,-0.388432,-0.864055
2453,0,0,0,0,2426,65,4944,4400,9344,-0.313862,-0.367862,-0.875311
4295,0,0,0,0,4227,120,8642,8823,17465,-0.324184,-0.419668,-0.847811
2594,0,0,0,0,2770,72,5436,4923,10359,-0.29274,-0.476885,-0.828785
2540,0,0,0,0,2590,73,5203,4717,9920,-0.324897,-0.44772,-0.83306
4549,0,0,0,0,4591,130,9270,5282,14552,-0.315374,-0.465918,-0.826716
2220,0,0,0,0,2229,70,4519,3849,8368,-0.374288,-0.470628,-0.79901
3604,0,0,0,0,3375,93,7072,6225,13297,-0.39398,-0.517616,-0.759509
5991,0,0,0,0,5071,145,11207,6282,17489,-0.42025,-0.562411,-0.712098
2121,0,0,0,0,1649,50,3820,3513,7333,-0.486139,-0.529067,-0.695526
2043,0,0,0,0,1537,50,3630,3385,7015,-0.48052,-0.525086,-0.702414
3474,0,0,0,0,2201,62,5737,5834,11571,-0.479383,-0.559432,-0.676186
2753,0,0,0,0,1828,50,4631,5995,10626,-0.449947,-0.545075,-0.707418
2321,0,0,0,0,1328,40,3689,3720,7409,-0.0959267,-0.123993,-0.987636
2460,0,0,0,0,1331,41,3832,3286,7118,-0.141664,-0.135146,-0.980646
2551,0,0,0,0,1123,34,3708,3486,7194,-0.0821374,-0.125522,-0.988685
6085,0,0,0,0,2545,80,8710,4607,13317,-0.0910962,-0.11607,-0.989055
2501,0,0,0,0,1091,33,3625,2678,6303,-0.079193,-0.0933095,-0.992483
1812,0,0,0,0,761,28,2601,2226,4827,-0.0653876,-0.0874806,-0.994018
3007,0,0,0,0,1204,38,4249,3709,7958,-0.0631779,-0.0759378,-0.995109
3625,0,0,0,0,1352,45,5022,4457,9479,-0.0872155,-0.0770158,-0.993208
2865,0,0,0,0,1134,35,4034,3683,7717,-0.0678483,-0.0551423,-0.996171
2327,0,0,0,0,887,29,3243,2922,6165,-0.0491723,-0.0604867,-0.996957
6152,0,0,0,0,2295,78,8525,3905,12430,-0.0924661,-0.0602663,-0.99389
2361,0,0,0,0,777,22,3160,2350,5510,-0.0727834,-0.0811376,-0.994042
1226,0,0,0,0,519,32,1777,1719,3496,-0.0317729,-0.0495416,-0.998267
5557,0,0,0,0,2071,67,7695,4177,11872,-0.0556626,-0.0704255,-0.995963
1941,0,0,0,0,736,23,2700,2915,5615,-0.0847758,-0.0887024,-0.992444
4889,0,0,0,0,1860,60,6809,6741,13550,-0.076146,-0.0162565,-0.996964
3483,0,0,0,0,1230,41,4754,4034,8788,-0.060238,-0.0466988,-0.997091
5378,0,0,0,0,1999,64,7441,4326,11767,-0.0542455,-0.0445746,-0.997532
2311,0,0,0,0,698,23,3032,2961,5993,-0.0284604,-0.033502,-0.999033
3025,0,0,0,0,1131,35,4191,4548,8739,-0.0463607,-0.0570651,-0.997293
3663,0,0,0,0,1412,46,5121,5123,10244,-0.050738,-0.0649465,-0.996598
3459,0,0,0,0,1422,44,4925,4610,9535,-0.0271563,-0.0582204,-0.997934
5515,0,0,0,0,2423,85,8023,4469,12492,-0.00816195,-0.0454314,-0.998934
2304,0,0,0,0,1109,38,3451,3264,6715,-0.0101515,-0.0837802,-0.996433
3282,0,0,0,0,1578,52,4912,5515,10427,-0.0172172,-0.103522,-0.994478
3235,0,0,0,0,1592,49,4876,5605,10481,0.00606722,-0.180801,-0.983501
3061,0,0,0,0,1536,53,4650,5192,9842,-0.0104746,-0.200376,-0.979663
3110,0,0,0,0,1558,62,4730,5590,10320,0.0387489,-0.0847203,-0.995651
2890,0,0,0,0,1432,42,4364,4212,8576,0.0455172,-0.0844689,-0.995386
2891,0,0,0,0,1486,44,4421,5046,9467,0.0110552,0.0103522,-0.999885
2876,0,0,0,0,1532,49,4457,3687,8144,0.0407786,-0.0650376,-0.997049
2867,0,0,0,0,1533,45,4445,3944,8389,0.0286012,-0.0850926,-0.995962
3263,0,0,0,0,1793,56,5112,4130,9242,0.0332624,-0.0960741,-0.994818
2569,0,0,0,0,1694,52,4315,3431,7746,0.042398,-0.0823543,-0.995701
3252,0,0,0,0,1854,63,5169,5183,10352,0.0386095,-0.0655109,-0.997105
4012,0,0,0,0,2257,78,6347,4291,10638,0.0463722,-0.116531,-0.992104
2452,0,0,0,0,1478,48,3978,3984,7962,0.0486065,-0.126169,-0.990817
2408,0,0,0,0,1525,46,3979,3001,6980,0.0276949,-0.0982257,-0.994779
3999,0,0,0,0,2265,68,6332,4318,10650,0.0400359,-0.121448,-0.99179
3407,0,0,0,0,2442,76,5925,3536,9461,0.0474069,-0.12033,-0.991601
2960,0,0,0,0,2660,64,5684,3699,9383,0.0499191,-0.111832,-0.992472
3032,0,0,0,0,2322,66,5420,3498,8918,0.0273238,-0.0909684,-0.995479
3016,0,0,0,0,2432,68,5516,3953,9469,0.0250359,-0.0935431,-0.9953
2511,0,0,0,0,2108,62,4681,2977,7658,0.0264117,-0.0839411,-0.996121
2487,0,0,0,0,2147,60,4694,3013,7707,0.0266287,-0.09118,-0.995478
6453,0,0,0,0,5282,148,11883,4470,16353,-0.00779442,-0.089217,-0.995982
6382,0,0,0,0,5716,156,12254,4082,16336,-0.0101054,-0.105141,-0.994406
2485,0,0,0,0,2387,57,4929,2112,7041,-0.0375353,-0.0722488,-0.99668
1626,0,0,0,0,1609,40,3275,1651,4926,-0.00728722,-0.0654657,-0.997828
1523,0,0,0,0,1589,42,3154,1946,5100,-0.00909521,-0.0682157,-0.997629
6281,0,0,0,0,6879,191,13351,3889,17240,-0.0149993,-0.0746395,-0.997098
2119,0,0,0,0,2536,71,4726,2281,7007,-0.00407358,-0.0529766,-0.998587
2020,0,0,0,0,2418,63,4501,2331,6832,-0.0289545,-0.0538419,-0.99813
7373,0,0,0,0,7537,216,15126,3707,18833,-0.0130158,-0.108134,-0.994051
2169,0,0,0,0,2752,77,4998,2112,7110,-0.0073642,-0.0749857,-0.997157
2057,0,0,0,0,3210,78,5345,2353,7698,-0.0237809,-0.0698178,-0.997276
3431,0,0,0,0,4515,130,8076,4134,12210,-0.0219423,-0.0884142,-0.995842
4652,0,0,0,0,5430,155,10237,4601,14838,0.0202454,-0.095867,-0.995188
2225,0,0,0,0,2550,70,4845,4532,9377,0.06154,-0.0756842,-0.995231
2548,0,0,0,0,2756,71,5375,5732,11107,0.0157244,-0.130345,-0.991344
3420,0,0,0,0,3339,130,6889,5822,12711,0.253961,-0.153354,-0.95498
2719,0,0,0,0,2373,67,5159,6056,11215,-0.134337,-0.412866,-0.900831
2218,0,0,0,0,1792,52,4062,3654,7716,-0.198268,-0.410002,-0.890274
4614,0,0,0,0,3227,96,7937,5662,13599,-0.174532,-0.465839,-0.867486
2641,0,0,0,0,1671,51,4363,4408,8771,-0.229607,-0.519763,-0.822877
5813,0,0,0,0,3236,107,9156,6509,15665,-0.257033,-0.631179,-0.731811
2335,0,0,0,0,1079,30,3444,2214,5658,-0.27749,-0.671606,-0.686982
1319,0,0,0,0,658,19,1996,1705,3701,-0.304369,-0.678875,-0.668198
1668,0,0,0,0,786,23,2477,2583,5060,-0.263196,-0.731287,-0.629243
5483,0,0,0,0,2385,80,7948,6660,14608,-0.26012,-0.877155,-0.403654
2282,0,0,0,0,952,30,3264,3811,7075,-0.195514,-0.878929,-0.435038
5380,0,0,0,0,2145,75,7600,-1,-1,-1,-1,-1
2347,0,0,0,0,731,23,3101,2225,5326,-0.0669236,-0.121113,-0.99038
1425,0,0,0,0,506,16,1947,1739,3686,-0.0466873,-0.0383423,-0.998173
1171,0,0,0,0,443,13,1627,1546,3173,-0.0460882,-0.0550074,-0.997422
2033,0,0,0,0,690,22,2745,2933,5678,-0.0484073,-0.0524915,-0.997447
5493,0,0,0,0,1658,58,7209,4812,12021,-0.0578059,-0.0883102,-0.994414
2206,0,0,0,0,717,28,2951,2722,5673,-0.062471,-0.115522,-0.991338
2930,0,0,0,0,937,30,3897,4087,7984,-0.0336133,-0.106542,-0.99374
3122,0,0,0,0,843,34,3999,4108,8107,-0.0390832,-0.114757,-0.992624
3033,0,0,0,0,894,29,3956,3857,7813,-0.0100865,-0.103977,-0.994529
3172,0,0,0,0,735,28,3935,3789,7724,-0.0129019,-0.0843327,-0.996354
2358,0,0,0,0,558,21,2937,3079,6016,-0.025477,-0.0951284,-0.995139
3303,0,0,0,0,791,31,4125,4540,8665,-0.0257994,-0.0904097,-0.99557
3280,0,0,0,0,783,31,4094,3828,7922,-0.0333496,-0.111557,-0.993198
2543,0,0,0,0,643,26,3212,3291,6503,-0.0177681,-0.11527,-0.993175
3185,0,0,0,0,813,31,4029,4044,8073,-0.0110245,-0.141779,-0.989837
3284,0,0,0,0,895,33,4212,4801,9013,-0.0174156,-0.119515,-0.99268
5436,0,0,0,0,1514,67,7017,3989,11006,-0.013564,-0.142759,-0.989665
2284,0,0,0,0,753,33,3070,3459,6529,-0.00710422,-0.127275,-0.991842
3095,0,0,0,0,1108,43,4246,3817,8063,0.000616206,-0.134316,-0.990938
5284,0,0,0,0,1890,68,7242,4380,11622,0.0195005,-0.142494,-0.989604
2708,0,0,0,0,1092,36,3836,3441,7277,0.00321225,-0.129912,-0.99152
4043,0,0,0,0,1741,62,5846,5240,11086,0.013591,-0.123505,-0.992251
3033,0,0,0,0,1463,43,4539,3965,8504,-0.00578585,-0.150152,-0.988646
4018,0,0,0,0,2076,58,6152,5589,11741,0.0104385,-0.204719,-0.978765
2951,0,0,0,0,1759,57,4767,4131,8898,-0.0212788,-0.145875,-0.989074
2760,0,0,0,0,1848,57,4665,5596,10261,-0.0097853,-0.215839,-0.97638
3030,0,0,0,0,2155,64,5249,8480,13729,0.274619,0.563084,-0.779436
2313,0,0,0,0,2032,55,4400,-1,-1,-1,-1,-1
2430,0,0,0,0,2023,59,4512,2674,7186,0.0102157,-0.138083,-0.990368
4979,0,0,0,0,4703,131,9813,12423,22236,-0.0489792,-0.118979,-0.991688
2317,0,0,0,0,2325,70,4712,9703,14415,-0.0675604,-0.097393,-0.99295
6098,0,0,0,0,6152,163,12413,-1,-1,-1,-1,-1
1598,0,0,0,0,1454,39,3091,1875,4966,0.00530029,-0.144941,-0.989426
1499,0,0,0,0,1450,42,2991,1946,4937,0.00543788,-0.139739,-0.990173
3154,0,0,0,0,3323,86,6563,3597,10160,0.00942836,-0.172488,-0.984967
3058,0,0,0,0,2450,74,5582,4191,9773,0.0165634,-0.194335,-0.980795
5886,0,0,0,0,4343,124,10353,3586,13939,0.0396478,-0.184358,-0.982059
2115,0,0,0,0,1309,37,3461,2415,5876,0.0528795,-0.176064,-0.982957
2250,0,0,0,0,1202,36,3488,2714,6202,0.0306396,-0.138577,-0.989878
5853,0,0,0,0,2588,82,8523,4691,13214,0.0542804,-0.166581,-0.984533
2946,0,0,0,0,1166,41,4153,3247,7400,0.0452763,-0.158664,-0.986294
2127,0,0,0,0,799,27,2953,2562,5515,0.0448111,-0.146615,-0.988178
4951,0,0,0,0,1872,54,6877,3771,10648,0.0400718,-0.144802,-0.988649
2113,0,0,0,0,758,29,2900,2672,5572,0.0407796,-0.120431,-0.991884
5892,0,0,0,0,1269,47,7208,3119,10327,0.0318034,-0.127299,-0.991354
1992,0,0,0,0,573,23,2588,2550,5138,0.0455657,-0.124887,-0.991124
5540,0,0,0,0,1575,63,7178,4454,11632,0.0476971,-0.18537,-0.981511
2328,0,0,0,0,643,26,2997,2378,5375,0.0295003,-0.156351,-0.987261
1494,0,0,0,0,356,12,1862,1686,3548,0.0541632,-0.0906583,-0.994408
5357,0,0,0,0,1720,57,7134,6036,13170,0.0421395,-0.154936,-0.987025
2889,0,0,0,0,1097,35,4021,2811,6832,0.0343779,-0.133643,-0.990433
1710,0,0,0,0,669,21,2400,2683,5083,0.0280968,-0.128558,-0.991304
3428,0,0,0,0,1340,42,4810,4645,9455,0.0479621,-0.105617,-0.99325
5323,0,0,0,0,3000,89,8412,4209,12621,0.0189102,-0.166896,-0.985793
2223,0,0,0,0,899,28,3150,2424,5574,0.0324667,-0.10343,-0.994107
1454,0,0,0,0,578,23,2055,1731,3786,0.0278422,-0.0996749,-0.99463
1701,0,0,0,0,689,25,2415,2315,4730,0.0289034,-0.078548,-0.996491
4734,0,0,0,0,1963,61,6758,5898,12656,0.0648204,-0.109779,-0.99184
2623,0,0,0,0,1110,34,3767,3336,7103,0.0293613,-0.0984175,-0.994712
5632,0,0,0,0,2147,69,7848,4360,12208,-0.00188302,-0.134347,-0.990933
2306,0,0,0,0,998,32,3336,2260,5596,0.00967691,-0.116277,-0.99317
1374,0,0,0,0,518,37,1929,1761,3690,0.0268576,-0.069844,-0.997196
1221,0,0,0,0,581,15,1817,1590,3407,0.00960508,-0.0841748,-0.996405
2581,0,0,0,0,1249,44,3874,3949,7823,0.0130943,-0.0898452,-0.99587
3238,0,0,0,0,1314,110,4662,4167,8829,-0.00238176,-0.0375474,-0.999292
3211,0,0,0,0,1390,41,4642,4341,8983,0.00336291,-0.0668459,-0.997758
3086,0,0,0,0,1418,51,4555,4254,8809,0.016672,-0.0626033,-0.997899
3153,0,0,0,0,1498,42,4693,4189,8882,0.0219784,-0.0859744,-0.996055
3081,0,0,0,0,1537,42,4660,3912,8572,0.0238152,-0.100515,-0.99465
3186,0,0,0,0,1482,44,4712,3029,7741,0.0139634,-0.109725,-0.993864
6582,0,0,0,0,3213,84,9879,3525,13404,0.0292978,-0.138651,-0.989908
2124,0,0,0,0,1086,37,3247,2565,5812,0.010167,-0.107582,-0.994144
6317,0,0,0,0,3436,99,9852,3953,13805,0.0145021,-0.183399,-0.982932
2312,0,0,0,0,1173,36,3521,2194,5715,0.0173668,-0.140362,-0.989948
1295,0,0,0,0,783,22,2100,1607,3707,0.00927474,-0.0825647,-0.996543
1493,0,0,0,0,923,29,2445,1914,4359,0.0208618,-0.0968189,-0.995083
3535,0,0,0,0,2170,71,5776,4924,10700,0.00182616,-0.0969553,-0.995287
4630,0,0,0,0,2783,103,7516,4047,11563,0.00709182,-0.104607,-0.994488
2193,0,0,0,0,1386,41,3620,2680,6300,0.0139864,-0.0988987,-0.994999
2143,0,0,0,0,1465,51,3659,2548,6207,0.0150026,-0.0898846,-0.995839
3694,0,0,0,0,2554,79,6327,4327,10654,0.0163216,-0.0995281,-0.994901
5699,0,0,0,0,4194,134,10027,3195,13222,0.014463,-0.1081,-0.994035
2537,0,0,0,0,1497,49,4083,2380,6463,0.015026,-0.0863506,-0.996151
2163,0,0,0,0,1840,51,4054,2586,6640,0.0152916,-0.0757417,-0.99701
3061,0,0,0,0,2597,69,5727,3572,9299,0.0191933,-0.0858297,-0.996125
3764,0,0,0,0,3139,87,6990,3710,10700,0.00834147,-0.107641,-0.994155
2897,0,0,0,0,2533,73,5503,3271,8774,0.0116836,-0.101212,-0.994796
2913,0,0,0,0,2803,87,5803,3290,9093,-0.0115148,-0.0942466,-0.995482
4182,0,0,0,0,3717,107,8006,5156,13162,0.0204758,-0.0828041,-0.996355
3240,0,0,0,0,2604,75,5919,3008,8927,0.00241165,-0.087472,-0.996164
2060,0,0,0,0,1608,45,3713,2490,6203,-0.0028446,-0.0761044,-0.997096
2439,0,0,0,0,1758,50,4247,2808,7055,-0.00532509,-0.0734835,-0.997282
5530,0,0,0,0,3726,106,9362,5172,14534,0.00324315,-0.15347,-0.988148
2637,0,0,0,0,1504,42,4183,2350,6533,-0.000709864,-0.114227,-0.993454
1593,0,0,0,0,907,26,2526,1664,4190,-0.00512806,-0.0641186,-0.997929
1406,0,0,0,0,801,23,2230,1724,3954,-0.0197532,-0.0492291,-0.998592
5524,0,0,0,0,2976,88,8588,5453,14041,-0.00714815,-0.0474334,-0.998849
2812,0,0,0,0,1547,48,4407,2598,7005,-0.0190778,-0.0202509,-0.999613
2079,0,0,0,0,1070,31,3180,2694,5874,-0.0484672,-0.00102481,-0.998824
5363,0,0,0,0,2826,87,8276,4740,13016,-0.039489,0.0400917,-0.998415
2564,0,0,0,0,1214,37,3815,2363,6178,-0.0246465,0.0505373,-0.998418
1642,0,0,0,0,874,26,2542,1765,4307,-0.0239482,0.0415484,-0.998849
1161,0,0,0,0,760,20,1941,1467,3408,-0.0214925,0.0501177,-0.998512
5996,0,0,0,0,3396,99,9491,3946,13437,-0.0275325,0.0668415,-0.997384
2342,0,0,0,0,1613,47,4002,2835,6837,-0.012243,0.0682421,-0.997594
6235,0,0,0,0,4193,131,10559,3761,14320,-0.0249872,0.0991797,-0.994756
2130,0,0,0,0,1539,46,3715,2376,6091,-0.0140407,0.0928961,-0.995577
3085,0,0,0,0,2430,69,5584,4322,9906,-0.00752992,0.109014,-0.994012
5818,0,0,0,0,4441,140,10399,3778,14177,0.00263197,0.117261,-0.993098
2054,0,0,0,0,1661,46,3761,2427,6188,0.00485357,0.104781,-0.994484
4725,0,0,0,0,4323,115,9163,6001,15164,0.025283,0.104418,-0.994212
3727,0,0,0,0,3093,87,6907,3403,10310,0.00937533,0.0773285,-0.996962
2666,0,0,0,0,2372,71,5109,3236,8345,0.019638,0.147377,-0.988885
3499,0,0,0,0,2947,80,6526,3822,10348,0.0373528,0.146779,-0.988464
3204,0,0,0,0,2640,72,5916,3628,9544,0.0224461,0.141386,-0.9897
2599,0,0,0,0,1968,57,4624,2990,7614,0.0196511,0.140795,-0.989844
3615,0,0,0,0,3101,76,6792,4394,11186,-0.00797645,0.160781,-0.986958
3989,0,0,0,0,2551,75,6615,4178,10793,0.00888794,0.163742,-0.986463
2755,0,0,0,0,2176,54,4985,3397,8382,0.0204363,0.120804,-0.992466
3501,0,0,0,0,2191,66,5758,3872,9630,0.0152433,0.136431,-0.990532
2630,0,0,0,0,1768,52,4450,3239,7689,0.0142908,0.124158,-0.99216
2752,0,0,0,0,1718,53,4523,3380,7903,0.041837,0.124737,-0.991307
2463,0,0,0,0,1567,50,4080,3354,7434,0.06225,0.115965,-0.991301
5863,0,0,0,0,3163,85,9111,3141,12252,0.039442,0.142086,-0.989068
2062,0,0,0,0,1276,36,3374,2578,5952,0.0337941,0.126784,-0.991355
2612,0,0,0,0,1676,52,4340,3326,7666,0.00861857,0.0971001,-0.995237
3889,0,0,0,0,2535,72,6496,4235,10731,0.0126403,0.105939,-0.994292
2972,0,0,0,0,1906,56,4934,3683,8617,0.0229356,0.11898,-0.992632
2826,0,0,0,0,1855,59,4740,3534,8274,0.0460786,0.104434,-0.993464
2763,0,0,0,0,1882,57,4702,3529,8231,0.0493047,0.108857,-0.992834
2908,0,0,0,0,1922,55,4885,3553,8438,0.030954,0.0911895,-0.995352
2809,0,0,0,0,1894,59,4762,4083,8845,0.0313779,0.0512553,-0.998193
5757,0,0,0,0,3959,142,9858,3622,13480,0.0461044,0.0711097,-0.996402
1985,0,0,0,0,1817,62,3864,2146,6010,0.0315977,0.0344598,-0.998906
2207,0,0,0,0,1729,50,3986,2720,6706,0.0464594,0.0502302,-0.997656
2989,0,0,0,0,2521,76,5586,3597,9183,0.0275883,0.0572017,-0.997981
3002,0,0,0,0,2550,70,5622,3705,9327,0.00253016,0.0840625,-0.996457
4880,0,0,0,0,4064,126,9070,5238,14308,0.083172,0.118501,-0.989464
3035,0,0,0,0,2568,72,5675,3410,9085,0.0349987,0.0768104,-0.996431
2790,0,0,0,0,2552,71,5413,3288,8701,0.0340386,0.066627,-0.997197
4039,0,0,0,0,4017,115,8171,4414,12585,0.0227762,0.128873,-0.9914
3211,0,0,0,0,3220,99,6530,4244,10774,0.122229,0.128615,-0.984133
3143,0,0,0,0,3395,104,6642,3732,10374,0.00711931,0.114762,-0.993367
2555,0,0,0,0,2816,79,5450,3611,9061,0.0852428,0.121279,-0.988952
3022,0,0,0,0,3233,86,6341,4095,10436,0.116607,0.0865067,-0.989404
3066,0,0,0,0,3346,93,6505,3788,10293,0.0750997,0.06805,-0.994851
2810,0,0,0,0,3176,84,6070,3742,9812,0.09584,0.0615629,-0.993491
2764,0,0,0,0,3675,85,6524,3658,10182,0.0394675,0.0279691,-0.998829
2628,0,0,0,0,3044,91,5763,3407,9170,-0.00196542,0.00678868,-0.999975
5946,0,0,0,0,6813,180,12939,4539,17478,0.0103284,0.0571674,-0.998311
2435,0,0,0,0,2370,63,4868,2340,7208,0.00607231,0.0321473,-0.999465
1524,0,0,0,0,1558,41,3123,1677,4800,0.0373513,0.0328017,-0.998764
1329,0,0,0,0,1534,37,2900,1660,4560,-0.0352484,0.0151046,-0.999264
1974,0,0,0,0,2157,57,4188,2617,6805,0.000392867,0.0287292,-0.999587
4754,0,0,0,0,5055,139,9948,5033,14981,-0.0176135,0.0413629,-0.998989
2724,0,0,0,0,2845,80,5649,3480,9129,0.0158096,0.0389998,-0.999114
5467,0,0,0,0,5531,143,11141,4286,15427,-0.00709878,0.0638796,-0.997932
2365,0,0,0,0,2431,65,4861,2546,7407,0.0130211,0.0377493,-0.999202
2244,0,0,0,0,2183,58,4485,2948,7433,0.0256102,0.0367725,-0.998995
3524,0,0,0,0,3409,91,7024,4963,11987,0.0247554,0.0220209,-0.999451
2805,0,0,0,0,2985,73,5863,3466,9329,-0.0214302,0.0394286,-0.998993
2287,0,0,0,0,2024,60,4371,2775,7146,-0.00742676,0.0219024,-0.999733
3183,0,0,0,0,3158,75,6416,3638,10054,-0.00671003,0.0233777,-0.999704
3037,0,0,0,0,2638,72,5747,3686,9433,0.00619707,0.0227015,-0.999723
3147,0,0,0,0,2567,71,5785,3511,9296,-0.0108186,0.0268827,-0.99958
2848,0,0,0,0,2331,68,5247,3582,8829,-0.00896458,0.0329191,-0.999418
3463,0,0,0,0,2643,73,6179,4273,10452,0.00897462,0.00420203,-0.999951
2712,0,0,0,0,2034,57,4803,3269,8072,0.0178916,-0.0043549,-0.99983
2702,0,0,0,0,1777,50,4529,3599,8128,0.00912508,0.0254037,-0.999636
4012,0,0,0,0,2518,71,6601,4857,11458,-0.00469873,0.0604237,-0.998162
2426,0,0,0,0,1394,40,3860,3140,7000,-0.017989,0.0780707,-0.996786
2468,0,0,0,0,1326,38,3832,2985,6817,-0.0233629,0.0821367,-0.996347
4598,0,0,0,0,2289,78,6965,5831,12796,0.0291795,0.131098,-0.99094
3167,0,0,0,0,1710,49,4926,4268,9194,-0.546216,-0.098867,-0.831789
2087,0,0,0,0,1109,36,3232,2996,6228,-0.772523,-0.0885146,-0.628787
5542,0,0,0,0,3164,97,8803,-1,-1,-1,-1,-1
1701,0,0,0,0,949,27,2677,2009,4686,0.00171916,0.0572859,-0.998356
1708,0,0,0,0,1126,30,2864,2290,5154,-0.148645,0.092798,-0.984527
5727,0,0,0,0,3385,98,9210,3905,13115,-0.0236439,0.134313,-0.990657
2105,0,0,0,0,1193,36,3334,2630,5964,0.00530487,0.10742,-0.9942
2866,0,0,0,0,2018,56,4940,4500,9440,0.0553001,-0.05834,-0.996764
5400,0,0,0,0,3934,129,9463,3627,13090,0.00926532,0.101397,-0.994803
2395,0,0,0,0,1678,49,4122,3295,7417,0.0261845,0.00420444,-0.999648
1960,0,0,0,0,1515,42,3517,2644,6161,0.0569949,0.00914118,-0.998333
5124,0,0,0,0,3931,109,9164,-1,-1,-1,-1,-1
1926,0,0,0,0,1544,43,3513,1961,5474,0.00233661,0.117785,-0.993036
1990,0,0,0,0,1662,46,3698,2399,6097,-0.0202013,0.125761,-0.991855
6356,0,0,0,0,5529,132,12017,3863,15880,-0.0272052,0.202195,-0.978967
2334,0,0,0,0,1852,47,4233,2069,6302,-0.053561,0.170249,-0.983944
1531,0,0,0,0,1288,35,2854,1629,4483,-0.0185352,0.110657,-0.993686
1308,0,0,0,0,1151,31,2490,1663,4153,-0.0537958,0.099234,-0.993609
2555,0,0,0,0,2231,61,4847,3033,7880,-0.0170654,0.114784,-0.993244
3578,0,0,0,0,3161,95,6834,4294,11128,-0.0367718,0.112373,-0.992986
2824,0,0,0,0,2579,72,5475,3473,8948,-0.0214218,0.112599,-0.99341
6548,0,0,0,0,5580,153,12281,3905,16186,-0.0408669,0.130043,-0.990666
2169,0,0,0,0,1794,48,4011,2479,6490,-0.0189315,0.102737,-0.994528
5624,0,0,0,0,4630,136,10390,3948,14338,-0.0130819,0.116772,-0.993073
2415,0,0,0,0,1795,50,4260,3047,7307,-0.0159101,0.0869343,-0.996087
3042,0,0,0,0,2367,64,5473,3857,9330,-0.0122931,0.0880484,-0.99604
3036,0,0,0,0,2224,63,5323,3814,9137,-0.00380129,0.0846629,-0.996402
3642,0,0,0,0,2300,66,6008,4468,10476,0.0189415,0.0759991,-0.996928
2817,0,0,0,0,1770,58,4645,3693,8338,-0.00158515,0.120905,-0.992663
2712,0,0,0,0,1636,48,4396,4482,8878,-0.0161735,0.070969,-0.997347
3268,0,0,0,0,1863,66,5197,4096,9293,-0.00475976,0.0829926,-0.996539
2548,0,0,0,0,1328,46,3922,3230,7152,0.0103675,0.0962341,-0.995305
6398,0,0,0,0,2991,132,9521,4747,14268,0.0188097,0.187981,-0.981992
2399,0,0,0,0,1011,32,3442,2442,5884,0.0411411,0.116661,-0.992319
1620,0,0,0,0,610,23,2253,1678,3931,0.0108911,0.0909279,-0.995798
1396,0,0,0,0,547,17,1960,1767,3727,0.0130806,0.0543131,-0.998438
2732,0,0,0,0,991,31,3754,3506,7260,0.0173192,0.0734227,-0.997151
5341,0,0,0,0,1717,60,7118,5211,12329,-0.0313601,0.19428,-0.980445
2295,0,0,0,0,655,21,2971,4293,7264,0.120985,0.351783,-0.92823
3704,0,0,0,0,1031,34,4769,5075,9844,0.130216,0.474215,-0.870726
3616,0,0,0,0,1100,37,4753,-1,-1,-1,-1,-1
1228,0,0,0,0,389,30,1647,2738,4385,0.0258779,0.211113,-0.977119
5276,0,0,0,0,1439,50,6765,7374,14139,0.065608,0.256189,-0.964398
2220,0,0,0,0,550,24,2794,3480,6274,0.0611571,0.173674,-0.982902
2383,0,0,0,0,501,21,2905,4558,7463,0.083078,0.164026,-0.982951
5275,0,0,0,0,1192,45,6512,5797,12309,0.0574218,0.268178,-0.961657
5184,0,0,0,0,1328,48,6560,4436,10996,0.0636015,0.509178,-0.858308
5992,0,0,0,0,1483,55,7530,5725,13255,0.0803811,0.683313,-0.725688
5394,0,0,0,0,1340,58,6792,6486,13278,0.0253961,0.536034,-0.843814
2548,0,0,0,0,603,24,3175,4199,7374,0.140512,0.521448,-0.841635
1444,0,0,0,0,405,16,1865,1652,3517,-0.0331172,0.342972,-0.938762
5475,0,0,0,0,1624,54,7153,4870,12023,0.050415,0.0481269,-0.997568
4798,0,0,0,0,1241,32,6071,3708,9779,0.0457799,0.0372428,-0.998257
1733,0,0,0,0,515,17,2265,2439,4704,0.02049,0.11602,-0.993035
2452,0,0,0,0,953,34,3439,3595,7034,0.0093879,0.147726,-0.988984
5313,0,0,0,0,1706,55,7074,6966,14040,0.0326187,0.110819,-0.993305
3750,0,0,0,0,1122,41,4913,4188,9101,0.0231126,0.127575,-0.99156
2232,0,0,0,0,717,25,2974,3495,6469,0.0270345,0.108163,-0.993765
5263,0,0,0,0,1939,64,7266,5505,12771,0.0340608,0.119178,-0.992288
2262,0,0,0,0,788,27,3077,2542,5619,0.0277909,0.100133,-0.994586
2022,0,0,0,0,738,28,2788,2637,5425,0.0259257,0.102438,-0.994401
5333,0,0,0,0,1890,71,7294,5069,12363,0.0171375,0.0983294,-0.995006
2758,0,0,0,0,990,37,3785,3248,7033,0.024668,0.057476,-0.998042
2648,0,0,0,0,970,36,3654,3555,7209,0.00895951,0.080326,-0.996728
4340,0,0,0,0,1385,54,5779,5511,11290,0.0101479,0.0934347,-0.995574
2368,0,0,0,0,833,32,3233,3248,6481,0.0327252,0.057109,-0.997831
3617,0,0,0,0,1453,41,5111,4893,10004,-0.0152077,0.0799832,-0.99668
5485,0,0,0,0,1911,65,7461,4431,11892,-0.00333104,0.0901093,-0.995926
1942,0,0,0,0,705,27,2674,2248,4922,0.0115006,0.0574478,-0.998282
2386,0,0,0,0,1201,37,3624,3217,6841,-0.0236622,0.0891809,-0.995734
6173,0,0,0,0,4084,112,10369,4150,14519,-0.00489967,0.0857351,-0.996306
2433,0,0,0,0,1697,56,4186,2529,6715,-0.00302221,0.0894914,-0.995983
1963,0,0,0,0,1542,45,3550,2508,6058,-0.0209173,0.0734114,-0.997082
4775,0,0,0,0,3787,106,8668,6037,14705,-0.0074768,0.105231,-0.99442
2737,0,0,0,0,2283,70,5090,2748,7838,-0.0060279,0.0862569,-0.996255
2130,0,0,0,0,1798,50,3978,2686,6664,0.00798099,0.0897627,-0.995931
6121,0,0,0,0,5099,140,11360,3631,14991,0.0201794,0.106959,-0.994059
2083,0,0,0,0,1806,51,3940,2498,6438,0.00259201,0.0706335,-0.997499
5936,0,0,0,0,5391,101,11428,3344,14772,-0.0106498,0.0814261,-0.996622
2155,0,0,0,0,1889,52,4096,2514,6610,-0.0253587,0.0716408,-0.997108
2119,0,0,0,0,1892,50,4061,2353,6414,-0.00513545,0.0608115,-0.998136
4154,0,0,0,0,3330,96,7580,4987,12567,-0.00676537,0.0722007,-0.997367
2893,0,0,0,0,2390,69,5352,3322,8674,-0.00737459,0.0553614,-0.998439
2828,0,0,0,0,2035,58,4921,3457,8378,-0.000752679,0.0489605,-0.9988
6345,0,0,0,0,3889,124,10358,3448,13806,-0.012246,0.0535796,-0.998488
1994,0,0,0,0,1296,36,3326,2432,5758,-0.00396102,0.0435471,-0.999044
6446,0,0,0,0,3782,139,10367,3706,14073,-0.0384178,0.0890087,-0.99529
2276,0,0,0,0,1159,34,3469,2164,5633,0.00432655,0.0579951,-0.998307
1721,0,0,0,0,799,24,2544,1478,4022,-0.0233604,0.0371914,-0.999035
1781,0,0,0,0,1101,32,2914,2438,5352,-0.0379625,0.0703856,-0.996797
4649,0,0,0,0,2824,82,7555,4562,12117,0.0033915,0.0890081,-0.996025
2605,0,0,0,0,1546,46,4197,3479,7676,0.0102161,0.0665023,-0.997734
2580,0,0,0,0,1386,42,4008,3422,7430,-0.0059163,0.059751,-0.998196
3836,0,0,0,0,1806,55,5697,4730,10427,-0.00282373,0.0846957,-0.996403
2894,0,0,0,0,1065,36,3995,3793,7788,-0.00206909,0.0886386,-0.996062
5511,0,0,0,0,1869,71,7451,3792,11243,0.01057,0.0924659,-0.99566
1865,0,0,0,0,583,21,2469,2600,5069,-0.0117641,0.0306355,-0.999461
3647,0,0,0,0,1089,38,4774,6073,10847,0.00159981,0.0844959,-0.996423
4008,0,0,0,0,1035,38,5081,4036,9117,-0.0206923,0.0453266,-0.998758
2264,0,0,0,0,597,24,2885,3377,6262,-0.0351309,0.0200306,-0.999182
2898,0,0,0,0,677,34,3609,3797,7406,-0.0259548,0.0352313,-0.999042
2609,0,0,0,0,615,30,3254,3506,6760,-0.0235018,0.0303049,-0.999264
6400,0,0,0,0,1378,62,7840,4074,11914,0.0011237,0.101949,-0.994789
2370,0,0,0,0,453,21,2844,2327,5171,-0.00622183,0.0623916,-0.998032
1456,0,0,0,0,372,13,1841,1723,3564,-0.0140488,0.0338015,-0.99933
1137,0,0,0,0,303,11,1451,1529,2980,-0.00520311,0.0391023,-0.999222
6115,0,0,0,0,1767,62,7944,4168,12112,-0.00219075,0.0715784,-0.997433
6050,0,0,0,0,1790,63,7903,3689,11592,-0.0213251,0.0590027,-0.99803
2278,0,0,0,0,861,25,3164,2842,6006,-0.024421,0.0333246,-0.999146
3116,0,0,0,0,960,31,4107,5966,10073,0.0510336,0.105184,-0.993142
2630,0,0,0,0,742,27,3399,3676,7075,-0.0220936,0.0507926,-0.998465
5306,0,0,0,0,1744,56,7106,3809,10915,-0.00697657,0.080433,-0.996736
2319,0,0,0,0,888,28,3235,2951,6186,-0.0150226,0.052969,-0.998483
3210,0,0,0,0,1253,41,4504,4239,8743,0.000144059,0.0816186,-0.996664
5640,0,0,0,0,2273,71,7984,3778,11762,0.0138696,0.0792409,-0.996759
2024,0,0,0,0,854,26,2904,2468,5372,0.012293,0.0983263,-0.995078
3075,0,0,0,0,1556,47,4678,3887,8565,0.0212468,0.0839084,-0.996247
5634,0,0,0,0,3073,123,8830,3672,12502,0.0401414,0.104938,-0.993668
6464,0,0,0,0,3604,113,10181,4407,14588,0.114064,0.169509,-0.978906
2380,0,0,0,0,1465,42,3887,2365,6252,0.100886,0.119634,-0.987679
1672,0,0,0,0,1054,29,2755,1710,4465,0.0700329,0.105021,-0.992001
1389,0,0,0,0,1030,28,2447,1696,4143,0.0696465,0.103877,-0.992149
2598,0,0,0,0,2240,64,4902,3061,7963,0.0846358,0.121808,-0.988939
4897,0,0,0,0,4458,122,9477,4670,14147,0.0770208,0.179671,-0.980707
2842,0,0,0,0,2791,86,5719,2676,8395,0.0747868,0.141468,-0.987114
6002,0,0,0,0,6090,166,12258,3507,15765,0.169981,0.236052,-0.956758
2483,0,0,0,0,2297,62,4842,2115,6957,0.116476,0.187838,-0.975269
1472,0,0,0,0,1721,51,3244,1473,4717,0.0817024,0.120991,-0.989286
1533,0,0,0,0,1889,48,3470,1680,5150,0.0950068,0.137419,-0.985946
6608,0,0,0,0,7382,209,14199,3971,18170,0.139436,0.171686,-0.975234
2615,0,0,0,0,3012,80,5707,2498,8205,0.145923,0.128082,-0.98097
2765,0,0,0,0,3093,81,5939,3470,9409,0.131428,0.200612,-0.970815
3965,0,0,0,0,4100,110,8175,4331,12506,0.13288,0.178084,-0.975002
3010,0,0,0,0,2916,85,6011,3717,9728,0.139886,0.123254,-0.982466
5809,0,0,0,0,4894,96,10799,4848,15647,0.152519,0.167535,-0.973997
1758,0,0,0,0,1397,38,3193,2758,5951,0.177232,0.159315,-0.971189
2523,0,0,0,0,1777,50,4350,4380,8730,0.266331,0.242468,-0.932886
3557,0,0,0,0,2470,70,6097,6483,12580,0.164959,0.32002,-0.932939
5490,0,0,0,0,3709,111,9310,3749,13059,0.206362,0.368077,-0.906606
1962,0,0,0,0,1253,40,3255,2722,5977,0.237021,0.406521,-0.882361
5703,0,0,0,0,3331,96,9130,8007,17137,0.376958,0.472076,-0.796898
2597,0,0,0,0,1353,39,3989,-1,-1,-1,-1,-1
1480,0,0,0,0,799,21,2300,2192,4492,0.0514771,0.178807,-0.982537
1279,0,0,0,0,702,21,2002,2228,4230,0.0711849,0.306603,-0.949172
2872,0,0,0,0,1547,46,4465,4782,9247,0.109634,0.457222,-0.882569
5485,0,0,0,0,2732,81,8298,4514,12812,0.145214,0.537858,-0.830435
2359,0,0,0,0,1144,40,3543,3405,6948,0.178131,0.532009,-0.82779
3967,0,0,0,0,1750,53,5770,6195,11965,0.198813,0.59261,-0.780568
2968,0,0,0,0,1235,37,4240,4203,8443,0.154855,0.595322,-0.788424
2452,0,0,0,0,930,28,3410,3696,7106,0.221716,0.231912,-0.947132
3324,0,0,0,0,1299,40,4663,13694,18357,0.0831326,0.195914,-0.977091
2428,0,0,0,0,733,24,3185,3463,6648,0.0814564,0.0994214,-0.991706
6659,0,0,0,0,1905,64,8628,4835,13463,0.0858334,0.0988136,-0.991397
1975,0,0,0,0,593,19,2587,2487,5074,0.0836694,0.0788403,-0.99337
2140,0,0,0,0,565,20,2725,3136,5861,0.0665394,0.0934358,-0.993399
5425,0,0,0,0,1366,58,6849,5447,12296,0.0807282,0.0698442,-0.994286
2277,0,0,0,0,622,23,2922,3547,6469,0.102644,0.0925612,-0.990402
2133,0,0,0,0,506,19,2658,3414,6072,0.0921144,0.0825258,-0.992323
2971,0,0,0,0,668,25,3664,5148,8812,0.129466,0.132012,-0.982757
5255,0,0,0,0,1266,56,6577,6005,12582,0.0596068,0.0931719,-0.993864
2202,0,0,0,0,500,22,2724,3617,6341,0.0871488,0.110606,-0.990036
2431,0,0,0,0,539,25,2995,3492,6487,0.0975667,0.0725623,-0.99258
4716,0,0,0,0,1118,48,5882,5911,11793,0.106555,0.0754107,-0.991443
