Downsample[ns],BuildFilTree[ns],SearchFil[ns],DeleteFil[ns],BuildTreeSub[ns],SearchSub[ns],DeleteSub[ns],PreProcTotal[ns],Plane[ns],Total[ns],nx,ny,nz
7808,0,0,0,0,8845,201,16854,5126,21980,0.00717714,-0.0366053,-0.999304
1830,0,0,0,0,2620,73,4523,3294,7817,-0.0130267,-0.0201738,-0.999712
1585,0,0,0,0,2072,53,3710,3617,7327,-0.0429598,0.0136874,-0.998983
6726,0,0,0,0,8724,161,15611,5602,21213,-0.0534833,0.0413803,-0.997711
1793,0,0,0,0,2155,55,4003,3229,7232,0.0164798,0.000305169,-0.999864
1660,0,0,0,0,2124,56,3840,3502,7342,0.00405289,-0.0316331,-0.999491
6564,0,0,0,0,8878,229,15671,5400,21071,-0.00928987,-0.0423838,-0.999058
1756,0,0,0,0,2166,57,3979,3184,7163,-0.0337922,-0.0534271,-0.998
1665,0,0,0,0,2275,64,4004,3500,7504,-0.00124081,-0.0386338,-0.999253
1872,0,0,0,0,2441,79,4392,4344,8736,0.0108457,-0.0122619,-0.999866
2633,0,0,0,0,2689,102,5424,4040,9464,0.0201232,0.0252897,-0.999478
1934,0,0,0,0,2624,82,4640,4152,8792,0.0175219,-0.0209493,-0.999627
1811,0,0,0,0,2338,73,4222,4105,8327,0.0120132,-0.0435892,-0.998977
2409,0,0,0,0,3310,87,5806,5827,11633,0.0164756,-0.0814171,-0.996544
2439,0,0,0,0,3474,92,6005,4963,10968,0.0164692,-0.118829,-0.992778
6998,0,0,0,0,9138,259,16395,5224,21619,0.00199932,-0.0388338,-0.999244
1777,0,0,0,0,2310,57,4144,3476,7620,-0.0324495,-0.0124008,-0.999396
6971,0,0,0,0,8591,178,15740,4946,20686,-0.0425359,-0.00768738,-0.999065
1805,0,0,0,0,2365,78,4248,2993,7241,-0.0698468,-0.0029204,-0.997553
1954,0,0,0,0,2570,80,4604,4120,8724,-0.0684116,0.019875,-0.997459
2078,0,0,0,0,2925,81,5084,4339,9423,-0.0622412,0.00156646,-0.99806
2693,0,0,0,0,3594,130,6417,6614,13031,-0.0762054,0.00701918,-0.997067
2443,0,0,0,0,3319,98,5860,4551,10411,-0.0678155,0.00637418,-0.997678
1763,0,0,0,0,2482,83,4328,4105,8433,-0.0662868,0.0244657,-0.997501
2193,0,0,0,0,2978,90,5261,4507,9768,-0.0863395,0.00381222,-0.996258
2188,0,0,0,0,3724,102,6014,4990,11004,-0.0135405,-0.0373845,-0.999209
1728,0,0,0,0,2281,61,4070,4144,8214,0.00766333,-0.0235049,-0.999694
1810,0,0,0,0,2390,67,4267,4267,8534,-0.035541,8.00832e-05,-0.999368
1952,0,0,0,0,2695,71,4718,3865,8583,-0.0888372,-0.00282751,-0.996042
8353,0,0,0,0,5881,134,14368,4554,18922,-0.0416755,-0.0442184,-0.998152
1853,0,0,0,0,2495,95,4443,3703,8146,-0.084689,-0.0832825,-0.992921
1672,0,0,0,0,2342,86,4100,3531,7631,-0.0168269,-0.0394634,-0.999079
2797,0,0,0,0,3664,101,6562,4027,10589,-0.0242689,-0.0329073,-0.999164
1669,0,0,0,0,2274,65,4008,3809,7817,-0.0687321,-0.0323665,-0.99711
1877,0,0,0,0,2492,66,4435,4001,8436,-0.0178013,-0.0378637,-0.999124
7052,0,0,0,0,6688,126,13866,5475,19341,-0.0178455,-0.0959472,-0.995226
1721,0,0,0,0,2262,58,4041,3429,7470,0.0178146,-0.0463827,-0.998765
6642,0,0,0,0,8403,153,15198,5561,20759,-0.0232922,-0.0450637,-0.998713
1761,0,0,0,0,2264,54,4079,3493,7572,-0.0607761,-0.0147781,-0.998042
1790,0,0,0,0,2387,64,4241,3780,8021,-0.0996768,-0.00365144,-0.995013
2086,0,0,0,0,2624,70,4780,4167,8947,-0.0106238,-0.0378824,-0.999226
1951,0,0,0,0,2608,69,4628,4461,9089,-0.0678564,-0.0269072,-0.997332
1978,0,0,0,0,2591,75,4644,4268,8912,-0.0718867,0.00253538,-0.99741
1931,0,0,0,0,2588,81,4600,4083,8683,-0.0911859,-0.00393038,-0.995826
6751,0,0,0,0,6752,157,13660,4759,18419,-0.0726393,-0.0024942,-0.997355
1736,0,0,0,0,2314,60,4110,3292,7402,-0.0724511,-0.017693,-0.997215
1865,0,0,0,0,2623,75,4563,4183,8746,-0.0901132,-0.0422509,-0.995035
7419,0,0,0,0,8719,243,16381,5136,21517,-0.00047415,-0.038733,-0.999249
1758,0,0,0,0,2433,68,4259,3486,7745,-0.0193179,-0.0347289,-0.99921
7957,0,0,0,0,7007,162,15126,5075,20201,-0.042246,-0.0675908,-0.996818
1738,0,0,0,0,2231,61,4030,3588,7618,-0.0569938,-0.083093,-0.994911
1691,0,0,0,0,2332,60,4083,3717,7800,-0.0194994,-0.0547708,-0.998309
2211,0,0,0,0,2840,74,5125,4798,9923,-0.0392579,-0.0548332,-0.997723
2149,0,0,0,0,2786,77,5012,4751,9763,-0.0546848,-0.0646263,-0.99641
6941,0,0,0,0,8438,163,15542,5197,20739,-0.106659,-0.0583976,-0.992579
1616,0,0,0,0,2349,57,4022,3111,7133,-0.0086094,-0.0359299,-0.999317
7481,0,0,0,0,8141,158,15780,5596,21376,-0.0127749,-0.0258502,-0.999584
1611,0,0,0,0,2192,55,3858,3466,7324,-0.0582091,-0.0173285,-0.998154
1675,0,0,0,0,2166,63,3904,3480,7384,-0.0674641,0.00696218,-0.997697
1604,0,0,0,0,1996,58,3658,3375,7033,-0.0999356,-0.0186477,-0.994819
1887,0,0,0,0,1986,61,3934,3051,6985,-0.000850089,-0.032724,-0.999464
1555,0,0,0,0,2147,86,3788,3486,7274,0.0012246,-0.0446446,-0.999002
2200,0,0,0,0,2944,61,5205,5408,10613,0.0139648,-0.0849292,-0.996289
2070,0,0,0,0,2869,62,5001,5043,10044,0.0338671,-0.133735,-0.990438
2080,0,0,0,0,2760,88,4928,4941,9869,0.00409513,-0.0386667,-0.999244
1527,0,0,0,0,1884,47,3458,3691,7149,-0.00610055,-0.033486,-0.999421
2727,0,0,0,0,3497,83,6307,4583,10890,-0.00824483,-0.032141,-0.999449
1860,0,0,0,0,2235,88,4183,4083,8266,-0.0464384,0.00359139,-0.998915
1691,0,0,0,0,2204,57,3952,3494,7446,-0.0794084,0.00805119,-0.99681
1622,0,0,0,0,2036,55,3713,3644,7357,-0.0657218,-0.00623645,-0.997818
1462,0,0,0,0,1766,49,3277,3419,6696,-0.0831238,-0.0116954,-0.996471
1529,0,0,0,0,1914,51,3494,3013,6507,-0.074087,-0.00803129,-0.997219
1423,0,0,0,0,1688,49,3160,3301,6461,-0.0272921,-0.0327069,-0.999092
1949,0,0,0,0,1996,71,4016,3921,7937,-0.0526345,-0.00229375,-0.998611
1565,0,0,0,0,1759,49,3373,3325,6698,-0.0605999,0.0229979,-0.997897
1492,0,0,0,0,1744,46,3282,3327,6609,-0.0721839,-0.0191793,-0.997207
1670,0,0,0,0,1907,48,3625,3433,7058,-0.0139777,-0.0375505,-0.999197
1494,0,0,0,0,1768,45,3307,3763,7070,-0.0279904,-0.0643644,-0.997534
1587,0,0,0,0,1713,60,3360,3563,6923,-0.0703317,-0.10077,-0.992421
1496,0,0,0,0,1639,43,3178,3416,6594,0.00321707,-0.0436947,-0.99904
1510,0,0,0,0,1517,40,3067,3481,6548,-0.0281645,-0.0771253,-0.996624
1436,0,0,0,0,1634,62,3132,3175,6307,0.00373651,-0.0379467,-0.999273
1475,0,0,0,0,1559,48,3082,3827,6909,0.0140803,-0.0651857,-0.997774
1723,0,0,0,0,1746,54,3523,3799,7322,0.0127833,-0.0894243,-0.995912
1575,0,0,0,0,1749,51,3375,3474,6849,0.00656691,-0.0428854,-0.999058
1604,0,0,0,0,1794,49,3447,4160,7607,0.0129256,-0.080357,-0.996682
2120,0,0,0,0,2265,60,4445,4150,8595,0.0252857,-0.0494796,-0.998455
1739,0,0,0,0,2142,53,3934,3928,7862,0.0343995,-0.106441,-0.993724
1583,0,0,0,0,1672,46,3301,3313,6614,0.0109635,-0.0425867,-0.999033
1540,0,0,0,0,1646,44,3230,3905,7135,0.00769886,-0.112884,-0.993578
1564,0,0,0,0,1699,47,3310,3219,6529,0.0198448,-0.0379967,-0.999081
1557,0,0,0,0,1661,45,3263,3563,6826,0.0306801,-0.0741178,-0.996777
2440,0,0,0,0,2564,92,5096,4518,9614,0.00920225,-0.0819827,-0.996591
2511,0,0,0,0,2295,96,4902,5612,10514,-0.0399456,-0.151015,-0.987724
2406,0,0,0,0,2333,66,4805,4820,9625,-0.0347687,-0.0796488,-0.996216
2344,0,0,0,0,2301,71,4716,4885,9601,-0.0103528,-0.0261281,-0.999605
2953,0,0,0,0,2868,69,5890,6787,12677,0.0109554,0.00293401,-0.999936
2824,0,0,0,0,2453,77,5354,5611,10965,0.0246232,0.0217905,-0.999459
3134,0,0,0,0,3120,70,6324,5592,11916,0.0215823,0.0833245,-0.996289
2506,0,0,0,0,2473,73,5052,5473,10525,-0.037243,0.0873954,-0.995477
2721,0,0,0,0,2410,67,5198,4619,9817,-0.0555808,0.0489066,-0.997256
1892,0,0,0,0,2016,53,3961,4256,8217,-0.0591482,0.0790654,-0.995113
1621,0,0,0,0,1784,46,3451,3933,7384,-0.0308523,0.112429,-0.993181
1775,0,0,0,0,1786,46,3607,3714,7321,-0.021903,0.123176,-0.992143
1991,0,0,0,0,2292,65,4348,4757,9105,0.015887,0.110824,-0.993713
1956,0,0,0,0,2216,59,4231,4649,8880,0.0587465,0.101815,-0.993067
6717,0,0,0,0,7768,127,14612,4943,19555,0.0444862,0.0757944,-0.996131
1706,0,0,0,0,1867,52,3625,3675,7300,0.0369149,0.0722625,-0.996702
1498,0,0,0,0,1643,47,3188,3506,6694,0.021816,0.070867,-0.997247
1407,0,0,0,0,1495,39,2941,3151,6092,0.00158813,0.0522736,-0.998632
1547,0,0,0,0,1519,41,3107,3256,6363,0.0259184,0.0536687,-0.998222
1374,0,0,0,0,1611,67,3052,3172,6224,0.00495815,0.0357411,-0.999349
1340,0,0,0,0,1616,66,3022,3268,6290,0.0324042,0.0539174,-0.998019
1376,0,0,0,0,1601,80,3057,3408,6465,0.0160597,0.0499937,-0.99862
1605,0,0,0,0,1542,64,3211,3140,6351,0.046894,0.0383885,-0.998162
2331,0,0,0,0,1721,84,4136,3195,7331,0.0502852,0.0109209,-0.998675
1513,0,0,0,0,1595,64,3172,3368,6540,0.0134833,-0.0362119,-0.999253
1657,0,0,0,0,1625,68,3350,3394,6744,0.00734224,-0.0445395,-0.998981
1555,0,0,0,0,1542,68,3165,3639,6804,-0.0151661,-0.0132491,-0.999797
1547,0,0,0,0,1541,68,3156,3580,6736,-0.0519115,-0.0108013,-0.998593
1440,0,0,0,0,1580,42,3062,3045,6107,-0.0245792,-0.0142501,-0.999596
1554,0,0,0,0,1570,67,3191,3111,6302,-0.0102462,-0.030797,-0.999473
1379,0,0,0,0,1588,41,3008,3531,6539,-0.0192409,-0.0368538,-0.999135
1381,0,0,0,0,1503,42,2926,3071,5997,-0.0216789,-0.0589285,-0.998027
1683,0,0,0,0,1466,66,3215,3579,6794,-0.000624613,-0.071175,-0.997464
1571,0,0,0,0,1560,42,3173,3070,6243,0.00729944,-0.0645527,-0.997888
1779,0,0,0,0,1450,43,3272,3122,6394,0.00359959,-0.0850519,-0.99637
1401,0,0,0,0,1413,34,2848,3380,6228,-0.00525784,-0.0583686,-0.998281
1445,0,0,0,0,1355,36,2836,3215,6051,-0.00185784,-0.0609435,-0.998139
1553,0,0,0,0,1429,41,3023,3372,6395,-0.0133941,-0.0805565,-0.99666
1427,0,0,0,0,1218,40,2685,3415,6100,0.00138734,-0.0623436,-0.998054
1480,0,0,0,0,1047,31,2558,2946,5504,0.00176507,-0.0757318,-0.997127
1454,0,0,0,0,980,44,2478,3642,6120,0.00396034,-0.062954,-0.998009
1438,0,0,0,0,1112,32,2582,3038,5620,-0.0129144,-0.0755444,-0.997059
1478,0,0,0,0,1128,52,2658,3099,5757,0.0109728,-0.0710723,-0.997411
1489,0,0,0,0,1163,32,2684,3490,6174,0.000178045,-0.06274,-0.99803
4453,0,0,0,0,2536,82,7071,4371,11442,-0.0138321,-0.0805212,-0.996657
1621,0,0,0,0,1142,32,2795,4361,7156,-0.00354537,-0.0776754,-0.996972
1673,0,0,0,0,1148,37,2858,3775,6633,-0.0143714,-0.0779067,-0.996857
2017,0,0,0,0,1351,42,3410,4842,8252,-0.00189559,-0.0726627,-0.997355
2426,0,0,0,0,1375,44,3845,4699,8544,-0.00483908,-0.0949665,-0.995469
5169,0,0,0,0,3274,103,8546,5036,13582,0.0155917,-0.0652647,-0.997746
1498,0,0,0,0,1056,32,2586,3419,6005,0.0187759,-0.0687466,-0.997457
5189,0,0,0,0,3637,105,8931,5496,14427,0.0180819,-0.106277,-0.994172
1831,0,0,0,0,1096,32,2959,3644,6603,0.0241857,-0.0998104,-0.994712
1512,0,0,0,0,941,28,2481,3690,6171,0.0257594,-0.109269,-0.993678
1495,0,0,0,0,1128,36,2659,3372,6031,0.0194155,-0.0581947,-0.998116
3205,0,0,0,0,996,69,4270,3640,7910,0.0040774,-0.0580137,-0.998307
1725,0,0,0,0,1019,46,2790,3619,6409,0.0140221,-0.081904,-0.996542
5803,0,0,0,0,3413,112,9328,5534,14862,0.00707541,-0.0969196,-0.995267
1643,0,0,0,0,1065,48,2756,3691,6447,0.0130581,-0.0615479,-0.998019
2049,0,0,0,0,1041,39,3129,3690,6819,0.0143452,-0.00655871,-0.999876
2101,0,0,0,0,1434,60,3595,4898,8493,0.0105573,0.0100602,-0.999894
5141,0,0,0,0,3410,99,8650,5152,13802,-0.0238307,-0.0424142,-0.998816
1663,0,0,0,0,1014,31,2708,3451,6159,0.0067028,-0.0633869,-0.997967
5978,0,0,0,0,4342,153,10473,6186,16659,0.00304244,-0.0844965,-0.996419
1758,0,0,0,0,1304,43,3105,3429,6534,0.00189005,-0.0632523,-0.997996
1745,0,0,0,0,1179,38,2962,3762,6724,-0.00808273,-0.0547395,-0.998468
6777,0,0,0,0,4574,127,11478,5998,17476,-0.00958511,-0.109296,-0.993963
1765,0,0,0,0,1356,45,3166,3505,6671,-0.0122892,-0.0827052,-0.996498
1629,0,0,0,0,1249,56,2934,3728,6662,0.00705167,-0.075789,-0.997099
2351,0,0,0,0,1740,58,4149,5393,9542,-0.0137031,-0.0684124,-0.997563
2209,0,0,0,0,1706,52,3967,5160,9127,0.0117276,-0.0757807,-0.997056
5935,0,0,0,0,4505,139,10579,5421,16000,0.00676186,-0.103331,-0.994624
1797,0,0,0,0,1195,34,3026,3311,6337,0.0288859,-0.0488485,-0.998388
5804,0,0,0,0,4465,127,10396,5561,15957,0.0184662,-0.119416,-0.992673
1766,0,0,0,0,1374,39,3179,3444,6623,0.0113993,-0.0958428,-0.995331
1240,0,0,0,0,1016,58,2314,3375,5689,0.0315704,-0.0807733,-0.996232
6864,0,0,0,0,4356,126,11346,5762,17108,0.0339776,-0.126799,-0.991346
1551,0,0,0,0,1127,32,2710,3226,5936,0.0257683,-0.059599,-0.99789
5771,0,0,0,0,4103,117,9991,5566,15557,0.0368995,-0.0969566,-0.994604
1521,0,0,0,0,1073,30,2624,3213,5837,0.0243847,-0.0594907,-0.997931
1551,0,0,0,0,1059,30,2640,3850,6490,0.0204184,-0.0346243,-0.999192
2081,0,0,0,0,1398,40,3519,5347,8866,0.0110825,-0.103663,-0.994551
2147,0,0,0,0,1356,44,3547,5320,8867,0.0246762,-0.0498243,-0.998453
2283,0,0,0,0,1308,38,3629,3789,7418,0.0242609,-0.0417191,-0.998835
1326,0,0,0,0,824,24,2174,3446,5620,0.0245293,-0.105076,-0.994162
2118,0,0,0,0,1355,38,3511,5214,8725,0.00973996,-0.0748014,-0.997151
5159,0,0,0,0,3281,98,8538,5822,14360,0.0223419,-0.0629909,-0.997764
1737,0,0,0,0,1093,32,2862,3208,6070,0.0250478,-0.036756,-0.99901
1548,0,0,0,0,1008,28,2584,3912,6496,0.0227491,-0.0516245,-0.998407
2531,0,0,0,0,1654,52,4237,6239,10476,0.0206449,-0.106585,-0.994089
2589,0,0,0,0,1710,54,4353,5967,10320,0.0160734,-0.138435,-0.990241
1888,0,0,0,0,1237,36,3161,4901,8062,0.0236629,-0.0955967,-0.995139
2371,0,0,0,0,1620,45,4036,5472,9508,0.0231159,-0.0458114,-0.998683
2595,0,0,0,0,1849,52,4496,6327,10823,0.0147219,-0.0910623,-0.995736
2235,0,0,0,0,1602,52,3889,5086,8975,0.0221205,-0.0643834,-0.99768
6082,0,0,0,0,4352,124,10558,5047,15605,0.0161594,-0.083038,-0.996415
1713,0,0,0,0,1145,35,2893,3020,5913,0.0288425,-0.0635216,-0.997564
1655,0,0,0,0,1297,36,2988,3714,6702,0.028472,-0.106461,-0.993909
2345,0,0,0,0,1864,55,4264,5211,9475,0.0133767,-0.104171,-0.994469
2633,0,0,0,0,2291,63,4987,5939,10926,-0.00812516,-0.0835046,-0.996474
2226,0,0,0,0,1865,63,4154,4958,9112,-0.0041023,-0.0718009,-0.997411
2477,0,0,0,0,2554,79,5110,6467,11577,0.0269248,-0.0833202,-0.996159
6121,0,0,0,0,5499,150,11770,5239,17009,0.0115827,-0.0931463,-0.995585
1643,0,0,0,0,1416,39,3098,2976,6074,0.0310847,-0.0816526,-0.996176
1620,0,0,0,0,1576,42,3238,3592,6830,0.0177607,-0.0652556,-0.997711
6550,0,0,0,0,6291,180,13021,5537,18558,0.0215489,-0.144122,-0.989325
1904,0,0,0,0,1911,65,3880,3197,7077,-0.0190359,-0.120238,-0.992563
1380,0,0,0,0,1473,39,2892,2997,5889,9.54677e-05,-0.0592345,-0.998244
1376,0,0,0,0,1423,38,2837,2885,5722,-0.00335149,-0.0734742,-0.997291
6119,0,0,0,0,6636,178,12933,5184,18117,-0.0143751,-0.0959509,-0.995282
1628,0,0,0,0,1848,50,3526,2923,6449,0.0105003,-0.0647653,-0.997845
6331,0,0,0,0,7034,190,13555,5114,18669,0.01086,-0.0847848,-0.99634
1650,0,0,0,0,1778,48,3476,3050,6526,0.00204917,-0.0556185,-0.99845
6647,0,0,0,0,7058,252,13957,5534,19491,-0.00761855,-0.110034,-0.993899
2030,0,0,0,0,2129,54,4213,3222,7435,-0.00915241,-0.100775,-0.994867
1292,0,0,0,0,1492,38,2822,2941,5763,0.000686857,-0.0825707,-0.996585
1345,0,0,0,0,1665,81,3091,2877,5968,-0.00508623,-0.0589227,-0.99825
1633,0,0,0,0,1657,44,3334,3377,6711,-0.0173708,-0.0501918,-0.998589
2329,0,0,0,0,2492,65,4886,5324,10210,-0.00492344,-0.0617239,-0.998081
6073,0,0,0,0,6664,186,12923,5063,17986,-0.0457719,-0.105107,-0.993407
1635,0,0,0,0,1744,45,3424,2937,6361,-0.0234679,-0.0627189,-0.997755
6029,0,0,0,0,6330,168,12527,5087,17614,-0.0223553,-0.0923115,-0.995479
1618,0,0,0,0,1650,39,3307,2966,6273,-0.0199323,-0.0398319,-0.999008
1509,0,0,0,0,1515,40,3064,3478,6542,-0.00370505,-0.0454763,-0.998959
2384,0,0,0,0,2511,67,4962,6257,11219,0.0116718,-0.0650958,-0.997811
2672,0,0,0,0,2430,66,5168,5721,10889,0.000383871,-0.0653652,-0.997861
1649,0,0,0,0,1544,41,3234,3991,7225,0.0213386,-0.0198528,-0.999575
1639,0,0,0,0,1545,42,3226,4300,7526,0.00913239,-0.0443668,-0.998974
6103,0,0,0,0,5237,171,11511,5615,17126,-0.016061,-0.151235,-0.988367
1862,0,0,0,0,1512,44,3418,3444,6862,-0.0117876,-0.114163,-0.993392
1335,0,0,0,0,1155,57,2547,3148,5695,-0.0346578,-0.0720852,-0.996796
1235,0,0,0,0,1092,32,2359,3261,5620,-0.0124407,-0.0265305,-0.999571
5917,0,0,0,0,5057,145,11119,5623,16742,-0.0261319,-0.137419,-0.990168
1588,0,0,0,0,1477,33,3098,3080,6178,-0.0376031,-0.100171,-0.994259
1297,0,0,0,0,954,30,2281,3423,5704,-0.0309379,-0.0823938,-0.99612
2349,0,0,0,0,1824,51,4224,6821,11045,-0.0288505,-0.135249,-0.990392
5661,0,0,0,0,4682,114,10457,5988,16445,-0.0350179,-0.130955,-0.99077
1726,0,0,0,0,1043,29,2798,3868,6666,-0.0223722,-0.0703532,-0.997271
1322,0,0,0,0,868,24,2214,4010,6224,-0.025677,-0.107761,-0.993845
2015,0,0,0,0,1280,36,3331,5332,8663,-0.0677857,-0.237333,-0.96906
2230,0,0,0,0,1514,47,3791,5960,9751,-0.0446071,-0.16237,-0.985721
2086,0,0,0,0,1397,38,3521,5055,8576,-0.0121801,-0.086155,-0.996207
2128,0,0,0,0,1338,45,3511,6613,10124,-0.0442102,-0.126891,-0.990931
6260,0,0,0,0,3552,113,9925,6617,16542,-0.0386755,-0.0531066,-0.99784
1747,0,0,0,0,880,30,2657,3317,5974,-0.0279334,-0.082452,-0.996203
6219,0,0,0,0,3328,124,9671,6595,16266,-0.0690992,-0.307677,-0.948979
1464,0,0,0,0,1048,30,2542,3702,6244,-0.0678722,-0.259946,-0.963235
1613,0,0,0,0,1041,27,2681,4558,7239,-0.0447302,-0.101482,-0.993831
1924,0,0,0,0,986,32,2942,4943,7885,-0.0408666,-0.289136,-0.956415
2283,0,0,0,0,979,28,3290,7002,10292,-0.0597622,-0.155255,-0.986065
1921,0,0,0,0,758,23,2702,5956,8658,-0.0385607,-0.109965,-0.993187
2943,0,0,0,0,849,30,3822,7503,11325,-0.0170449,-0.0790176,-0.996727
1831,0,0,0,0,686,26,2543,5488,8031,-0.0444557,-0.202654,-0.978241
5309,0,0,0,0,1963,63,7335,6231,13566,-0.0213597,-0.224844,-0.974161
1700,0,0,0,0,593,19,2312,4186,6498,-0.00935019,-0.0715037,-0.997397
1255,0,0,0,0,487,15,1757,3558,5315,0.0176068,0.0515778,-0.998514
1217,0,0,0,0,457,15,1689,3747,5436,0.0141422,0.0151043,-0.999786
1545,0,0,0,0,682,21,2248,4248,6496,0.0145285,0.0423566,-0.998997
5682,0,0,0,0,2779,84,8545,6156,14701,0.0205607,0.0317629,-0.999284
1556,0,0,0,0,792,27,2375,3375,5750,0.0276153,-0.0878563,-0.99575
5551,0,0,0,0,2997,90,8638,6999,15637,0.0241167,-0.13383,-0.990711
1719,0,0,0,0,954,34,2707,3788,6495,0.0434346,-0.165004,-0.985336
1218,0,0,0,0,802,23,2043,3290,5333,0.0514472,-0.183312,-0.981708
1948,0,0,0,0,1221,39,3208,5188,8396,0.00460222,-0.147433,-0.989061
2055,0,0,0,0,1427,50,3532,5171,8703,-0.0157469,-0.191245,-0.981416
2184,0,0,0,0,1583,51,3818,6083,9901,-0.015377,-0.250932,-0.967883
3251,0,0,0,0,2649,76,5976,8274,14250,-0.013072,-0.282304,-0.959236
6485,0,0,0,0,5102,96,11683,5818,17501,-0.0575154,-0.238751,-0.969376
1808,0,0,0,0,1565,48,3421,3277,6698,-0.0202348,-0.179657,-0.983521
1864,0,0,0,0,1409,35,3308,3525,6833,-0.0765021,-0.0895935,-0.993036
6291,0,0,0,0,6600,164,13055,5517,18572,-0.0137549,-0.125716,-0.991971
1725,0,0,0,0,1736,43,3504,3544,7048,-0.0200584,-0.142228,-0.989631
1669,0,0,0,0,1692,49,3410,4420,7830,-0.101194,-0.0952536,-0.990296
1861,0,0,0,0,1970,58,3889,4125,8014,-0.113337,-0.102461,-0.988259
3166,0,0,0,0,3322,101,6589,6405,12994,-0.0037595,-0.124201,-0.99225
2557,0,0,0,0,3049,75,5681,5308,10989,-0.00464307,-0.147812,-0.989005
1647,0,0,0,0,2038,63,3748,3801,7549,-0.0892961,-0.113948,-0.989466
2152,0,0,0,0,2487,66,4705,4776,9481,0.00490517,-0.11323,-0.993557
2775,0,0,0,0,3224,87,6086,6166,12252,-0.0613794,-0.110088,-0.992025
1995,0,0,0,0,2297,64,4356,4347,8703,-0.00205863,-0.116923,-0.993139
2517,0,0,0,0,2811,80,5408,5784,11192,0.000793624,-0.130035,-0.991509
2138,0,0,0,0,2303,66,4507,4826,9333,0.000252473,-0.114294,-0.993447
2324,0,0,0,0,2693,71,5088,5836,10924,0.0191623,-0.0958184,-0.995214
6241,0,0,0,0,8046,202,14489,5138,19627,-0.0121125,-0.136522,-0.990563
1693,0,0,0,0,1455,45,3193,2884,6077,0.0145997,-0.100336,-0.994847
6277,0,0,0,0,6006,175,12458,5268,17726,0.00162659,-0.134357,-0.990932
1715,0,0,0,0,1487,42,3244,2963,6207,0.0114029,-0.125019,-0.992089
1600,0,0,0,0,1299,39,2938,3241,6179,0.0282674,-0.121028,-0.992247
1984,0,0,0,0,1379,38,3401,3852,7253,0.0268541,-0.103568,-0.99426
2355,0,0,0,0,1559,50,3964,4824,8788,0.0263545,-0.11043,-0.993534
2408,0,0,0,0,1594,63,4065,5812,9877,0.0122548,-0.118857,-0.992836
2131,0,0,0,0,1382,45,3558,5987,9545,0.033558,-0.132091,-0.990669
2683,0,0,0,0,1428,44,4155,5266,9421,0.0241563,-0.105172,-0.994161
1809,0,0,0,0,963,31,2803,4533,7336,0.0238604,-0.0803875,-0.996478
2552,0,0,0,0,1034,33,3619,5017,8636,0.00592876,-0.0748248,-0.997179
2252,0,0,0,0,1198,37,3487,6157,9644,-0.029523,-0.124193,-0.991819
3128,0,0,0,0,1724,58,4910,5797,10707,-0.0350524,-0.117581,-0.992444
2104,0,0,0,0,1181,40,3325,5685,9010,-0.0380167,-0.116355,-0.99248
2138,0,0,0,0,1042,32,3212,4221,7433,-0.0463873,-0.107008,-0.993175
5710,0,0,0,0,3523,109,9342,5551,14893,-0.0537124,-0.110481,-0.992426
1536,0,0,0,0,1085,34,2655,3098,5753,-0.0235011,-0.0909464,-0.995578
5774,0,0,0,0,3746,114,9634,5860,15494,-0.0183693,-0.087454,-0.995999
1775,0,0,0,0,1111,34,2920,3016,5936,0.0118739,-0.0415384,-0.999066
1720,0,0,0,0,1260,45,3025,3904,6929,-0.0410411,-0.0768315,-0.996199
2895,0,0,0,0,2137,64,5096,6140,11236,-0.0217457,-0.07194,-0.997172
6157,0,0,0,0,4746,136,11039,5739,16778,-0.0399204,-0.107753,-0.993376
1915,0,0,0,0,1371,41,3327,3243,6570,-0.0389672,-0.106358,-0.993564
1319,0,0,0,0,999,26,2344,3302,5646,-0.0566378,-0.113713,-0.991898
1659,0,0,0,0,989,29,2677,3042,5719,-0.0105041,-0.0773625,-0.996948
1531,0,0,0,0,1148,32,2711,3425,6136,-0.0239761,-0.0875983,-0.995867
2624,0,0,0,0,1558,53,4235,5346,9581,0.00950209,-0.0561328,-0.998378
2384,0,0,0,0,1528,47,3959,6101,10060,-0.0304429,-0.0940108,-0.995106
1995,0,0,0,0,1285,40,3320,4438,7758,-0.0100567,-0.0691043,-0.997559
2133,0,0,0,0,1321,39,3493,4692,8185,-0.009774,-0.0748674,-0.997146
2721,0,0,0,0,1750,51,4522,5910,10432,-0.0261191,-0.0939311,-0.995236
2018,0,0,0,0,1249,38,3305,4514,7819,-0.0176893,-0.103497,-0.994472
2132,0,0,0,0,1438,42,3612,5118,8730,0.00180343,-0.0718498,-0.997414
2433,0,0,0,0,1654,47,4134,5684,9818,-0.0381998,-0.0807032,-0.996006
2084,0,0,0,0,1440,41,3565,4880,8445,-0.039716,-0.0709452,-0.996689
2427,0,0,0,0,1646,47,4120,5603,9723,-0.0656684,-0.0881911,-0.993937
2280,0,0,0,0,1581,46,3907,5797,9704,-0.0618961,-0.0923152,-0.993804
1965,0,0,0,0,1338,38,3341,4385,7726,-0.0121815,-0.068486,-0.997578
1968,0,0,0,0,1467,55,3490,4544,8034,-0.0338099,-0.0763151,-0.99651
1899,0,0,0,0,1377,39,3315,4330,7645,-0.0535937,-0.0881329,-0.994666
2423,0,0,0,0,1783,50,4256,5439,9695,-0.0776651,-0.0967995,-0.992269
2927,0,0,0,0,1898,56,4881,5322,10203,-0.0505466,-0.0872543,-0.994903
6588,0,0,0,0,5062,155,11805,5239,17044,-0.0680809,-0.0934459,-0.993294
1505,0,0,0,0,1264,34,2803,3166,5969,-0.0585911,-0.0865493,-0.994523
3756,0,0,0,0,3660,97,7513,6921,14434,-0.0917751,-0.10463,-0.990268
2331,0,0,0,0,1913,53,4297,3471,7768,-0.0636935,-0.0798523,-0.99477
3156,0,0,0,0,2467,76,5699,3953,9652,-0.0475982,-0.0728514,-0.996206
1384,0,0,0,0,1336,41,2761,3074,5835,-0.0175264,-0.0511724,-0.998536
6229,0,0,0,0,6268,192,12689,5140,17829,-0.0718543,-0.0891385,-0.993424
1757,0,0,0,0,1945,47,3749,2948,6697,-0.069102,-0.0841885,-0.994051
1821,0,0,0,0,1701,50,3572,3733,7305,-0.0494853,-0.0727331,-0.996123
2411,0,0,0,0,2402,65,4878,5170,10048,-0.0532076,-0.0719374,-0.995989
6694,0,0,0,0,6442,197,13333,5283,18616,-0.0719537,-0.0804933,-0.994155
1594,0,0,0,0,1543,43,3180,2948,6128,-0.0631341,-0.0744031,-0.995228
6160,0,0,0,0,6204,168,12532,4975,17507,-0.0928577,-0.0902974,-0.991576
1604,0,0,0,0,1614,41,3259,2832,6091,-0.0402176,-0.0583618,-0.997485
2366,0,0,0,0,1680,46,4092,3360,7452,-0.0227363,-0.0713817,-0.99719
2315,0,0,0,0,2719,76,5110,6390,11500,-0.093161,-0.101044,-0.990511
2830,0,0,0,0,2751,75,5656,5430,11086,-0.0599274,-0.069244,-0.995798
1886,0,0,0,0,1997,56,3939,4220,8159,-0.0538921,-0.0533441,-0.997121
1873,0,0,0,0,1953,59,3885,4281,8166,-0.0742453,-0.0855887,-0.99356
6152,0,0,0,0,6396,135,12683,5063,17746,-0.131044,-0.0923476,-0.987066
1627,0,0,0,0,1724,52,3403,3077,6480,-0.0802696,-0.0620883,-0.994838
6103,0,0,0,0,6411,192,12706,5344,18050,-0.0927424,-0.0888786,-0.991715
1685,0,0,0,0,1752,50,3487,2953,6440,-0.0615737,-0.053872,-0.996648
1766,0,0,0,0,1657,46,3469,3508,6977,-0.0941302,-0.0592618,-0.993795
2510,0,0,0,0,2451,66,5027,5592,10619,-0.0318141,-0.0625224,-0.997536
2472,0,0,0,0,2427,66,4965,5230,10195,-0.0615661,-0.0493829,-0.996881
6429,0,0,0,0,6208,184,12821,5438,18259,-0.115698,-0.075431,-0.990416
1964,0,0,0,0,1486,41,3491,2865,6356,-0.0376246,-0.0314745,-0.998796
1587,0,0,0,0,1919,52,3558,3487,7045,-0.0526515,-0.0652842,-0.996477
2361,0,0,0,0,2395,64,4820,5990,10810,-0.0716564,-0.0862468,-0.993694
2472,0,0,0,0,2427,76,4975,5403,10378,-0.116214,-0.120337,-0.985907
2030,0,0,0,0,2020,56,4106,4863,8969,-0.126796,-0.089134,-0.987916
2263,0,0,0,0,2372,64,4699,5668,10367,-0.0935664,-0.037168,-0.994919
2425,0,0,0,0,2284,64,4773,5603,10376,-0.185058,-0.0910832,-0.978497
2265,0,0,0,0,2073,56,4394,5431,9825,-0.210291,-0.113219,-0.971061
5955,0,0,0,0,5351,148,11454,5781,17235,-0.107124,-0.0450429,-0.993225
3120,0,0,0,0,2296,62,5478,4129,9607,-0.0906897,-0.045742,-0.994828
6336,0,0,0,0,5352,146,11834,5720,17554,-0.161669,-0.0760356,-0.983912
1579,0,0,0,0,1410,40,3029,3592,6621,-0.044278,-0.00650635,-0.998998
1689,0,0,0,0,1326,37,3052,3297,6349,-0.0560311,0.0031973,-0.998424
1736,0,0,0,0,1499,41,3276,3982,7258,-0.0549367,-0.00982046,-0.998442
6025,0,0,0,0,5333,143,11501,5460,16961,-0.0519293,-0.0162598,-0.998518
1617,0,0,0,0,1421,42,3080,2878,5958,-0.0191546,0.00945978,-0.999772
1596,0,0,0,0,1309,36,2941,3711,6652,-0.025803,0.00193127,-0.999665
2027,0,0,0,0,1804,54,3885,4746,8631,-0.0642873,-0.0176665,-0.997775
2420,0,0,0,0,1840,52,4312,5708,10020,-0.0609704,-0.0171359,-0.997992
2051,0,0,0,0,1475,41,3567,4979,8546,-0.0459384,-0.0154811,-0.998824
6026,0,0,0,0,4672,128,10826,5430,16256,-0.0913708,-0.00361953,-0.99581
3123,0,0,0,0,2122,48,5293,4182,9475,-0.134483,-0.0212372,-0.990688
1414,0,0,0,0,946,26,2386,3323,5709,-0.0923847,-0.0220796,-0.995479
1782,0,0,0,0,1207,36,3025,4593,7618,-0.103372,-0.00985413,-0.994594
2309,0,0,0,0,1274,41,3624,5577,9201,-0.0830003,-0.0155794,-0.996428
6103,0,0,0,0,3379,101,9583,5878,15461,-0.0993183,-0.0389135,-0.994295
2013,0,0,0,0,1036,32,3081,4653,7734,-0.10234,-0.0213479,-0.99452
1743,0,0,0,0,968,29,2740,4265,7005,-0.0757626,0.00019316,-0.997126
2525,0,0,0,0,1474,46,4045,6176,10221,-0.116429,-0.0366969,-0.992521
2113,0,0,0,0,1172,33,3318,4747,8065,-0.0785854,-0.056234,-0.99532
5673,0,0,0,0,2829,87,8589,5365,13954,-0.0826606,-0.0405915,-0.995751
1459,0,0,0,0,693,20,2172,3257,5429,-0.0697011,-0.0288454,-0.997151
1600,0,0,0,0,800,24,2424,4318,6742,-0.0923603,-0.0447265,-0.994721
2876,0,0,0,0,1922,53,4851,7623,12474,-0.0713648,-0.0283461,-0.997047
2307,0,0,0,0,1161,35,3503,5183,8686,-0.0704521,-0.0371899,-0.996822
1718,0,0,0,0,794,24,2536,4241,6777,-0.12021,-0.0733218,-0.990037
1624,0,0,0,0,754,24,2402,4449,6851,-0.0940551,-0.0535472,-0.994126
5551,0,0,0,0,2389,77,8017,5955,13972,-0.107669,-0.0979273,-0.989352
1641,0,0,0,0,646,24,2311,3396,5707,-0.074083,-0.0431345,-0.996319
1257,0,0,0,0,543,19,1819,3366,5185,-0.0829379,-0.0501298,-0.995293
5756,0,0,0,0,2442,80,8278,6027,14305,-0.0866273,-0.0698046,-0.993792
5517,0,0,0,0,2386,90,7993,6296,14289,-0.152789,-0.104792,-0.982687
1971,0,0,0,0,857,25,2853,3628,6481,-0.0976024,-0.0703857,-0.992733
1310,0,0,0,0,547,18,1875,3011,4886,-0.0937548,-0.0668023,-0.993352
1319,0,0,0,0,646,20,1985,3446,5431,-0.0394586,-0.0425939,-0.998313
5601,0,0,0,0,3146,94,8841,6141,14982,-0.142787,-0.121505,-0.982267
1718,0,0,0,0,1063,29,2810,3468,6278,-0.166634,-0.123237,-0.978287
1247,0,0,0,0,721,20,1988,3291,5279,-0.101111,-0.0794919,-0.991694
1363,0,0,0,0,825,23,2211,3212,5423,-0.110398,-0.086229,-0.99014
6273,0,0,0,0,3508,100,9881,5765,15646,-0.132738,-0.118075,-0.984093
1791,0,0,0,0,1051,30,2872,3937,6809,-0.11496,-0.095863,-0.988734
1718,0,0,0,0,816,23,2557,3115,5672,-0.137163,-0.11399,-0.983968
1408,0,0,0,0,1040,24,2472,4116,6588,-0.22207,-0.206513,-0.95291
1861,0,0,0,0,1401,39,3301,7353,10654,-0.261559,-0.239667,-0.934958
2420,0,0,0,0,1719,57,4196,8923,13119,-0.376031,-0.398647,-0.83647
1805,0,0,0,0,1502,41,3348,5856,9204,-0.408002,-0.434419,-0.803004
3016,0,0,0,0,2885,80,5981,10795,16776,-0.388818,-0.41739,-0.821344
1822,0,0,0,0,1739,46,3607,7228,10835,-0.301166,-0.325791,-0.896192
1616,0,0,0,0,1439,39,3094,5831,8925,-0.289065,-0.293192,-0.911307
1697,0,0,0,0,1781,46,3524,7543,11067,-0.20394,-0.352119,-0.913466
1903,0,0,0,0,1904,52,3859,5274,9133,-0.266272,-0.362612,-0.893091
2933,0,0,0,0,2795,77,5805,10132,15937,-0.327438,-0.299269,-0.896227
2006,0,0,0,0,1895,51,3952,6572,10524,-0.329396,-0.47141,-0.81809
1397,0,0,0,0,1427,38,2862,5060,7922,-0.329017,-0.35723,-0.874148
2502,0,0,0,0,2648,69,5219,9234,14453,-0.357786,-0.445792,-0.820523
1943,0,0,0,0,2056,72,4071,6389,10460,-0.373406,-0.49446,-0.784906
1794,0,0,0,0,1682,45,3521,5748,9269,-0.38164,-0.52357,-0.761725
1914,0,0,0,0,1786,57,3757,5782,9539,-0.383904,-0.610938,-0.692367
2273,0,0,0,0,2355,69,4697,8642,13339,-0.333695,-0.583474,-0.740409
2296,0,0,0,0,2119,50,4465,7182,11647,-0.383357,-0.552703,-0.739971
2004,0,0,0,0,1311,37,3352,6501,9853,-0.43584,-0.56835,-0.69787
1797,0,0,0,0,1233,40,3070,5882,8952,-0.523614,-0.614041,-0.590578
2035,0,0,0,0,1112,33,3180,5533,8713,-0.57184,-0.658642,-0.48907
2234,0,0,0,0,1341,54,3629,7186,10815,-0.593902,-0.664438,-0.453655
1908,0,0,0,0,981,33,2922,5423,8345,-0.595279,-0.725088,-0.346252
1757,0,0,0,0,933,27,2717,12156,14873,-0.56752,-0.717333,-0.404171
1415,0,0,0,0,610,19,2044,8692,10736,-0.559492,-0.729573,-0.393308
1457,0,0,0,0,723,22,2202,10480,12682,-0.473137,-0.756371,-0.451713
1567,0,0,0,0,729,22,2318,4455,6773,-0.466299,-0.774985,-0.426571
1994,0,0,0,0,867,30,2891,5810,8701,-0.419255,-0.79467,-0.439006
1965,0,0,0,0,779,25,2769,13655,16424,-0.425821,-0.837646,-0.342089
5636,0,0,0,0,2181,84,7901,-1,-1,-1,-1,-1
2002,0,0,0,0,551,19,2572,3079,5651,-0.0490245,-0.0588988,-0.997059
1401,0,0,0,0,510,17,1928,3291,5219,-0.0637075,-0.00769837,-0.997939
5702,0,0,0,0,2267,76,8045,9292,17337,-0.0955468,-0.0945927,-0.99092
2852,0,0,0,0,910,35,3797,4395,8192,-0.0998069,-0.0616423,-0.993096
1606,0,0,0,0,515,19,2140,3313,5453,-0.0710855,-0.0813568,-0.994147
1260,0,0,0,0,441,14,1715,3252,4967,-0.048098,-0.0793057,-0.995689
2053,0,0,0,0,723,23,2799,5641,8440,-0.061338,-0.0434573,-0.997171
2175,0,0,0,0,815,26,3016,6653,9669,-0.0850246,-0.0227724,-0.996119
5419,0,0,0,0,1968,104,7491,5654,13145,-0.0438956,-0.00686252,-0.999013
6167,0,0,0,0,2247,75,8489,6595,15084,-0.0585591,-0.0579304,-0.996602
1848,0,0,0,0,643,21,2512,3453,5965,-0.0431684,-0.0161743,-0.998937
1291,0,0,0,0,468,16,1775,3359,5134,-0.019351,-0.0771877,-0.996829
1612,0,0,0,0,594,19,2225,4260,6485,-0.05895,-0.0505729,-0.996979
2240,0,0,0,0,927,30,3197,6592,9789,-0.0460217,-0.0928035,-0.99462
2245,0,0,0,0,947,30,3222,5455,8677,-0.016864,-0.0877034,-0.996004
2015,0,0,0,0,968,29,3012,5482,8494,-0.0190258,-0.0918094,-0.995595
1785,0,0,0,0,851,26,2662,4658,7320,-0.0340834,-0.0846469,-0.995828
5652,0,0,0,0,3430,89,9171,5878,15049,-0.0145889,-0.0995829,-0.994922
1518,0,0,0,0,723,23,2264,3749,6013,0.0236764,-0.0859642,-0.996017
1819,0,0,0,0,744,23,2586,3837,6423,0.0581958,-0.0836895,-0.994791
2044,0,0,0,0,1022,32,3098,5523,8621,0.023074,-0.116932,-0.992872
2437,0,0,0,0,1067,36,3540,5747,9287,0.017633,-0.100318,-0.994799
1816,0,0,0,0,1204,29,3049,4540,7589,0.0443756,-0.0840511,-0.995473
6334,0,0,0,0,3049,111,9494,6302,15796,0.0268849,-0.0386801,-0.99889
1869,0,0,0,0,790,25,2684,3318,6002,0.0336102,-0.0767805,-0.996481
5685,0,0,0,0,3322,93,9100,5150,14250,0.0301449,-0.134687,-0.990429
1499,0,0,0,0,852,29,2380,3472,5852,0.0504611,-0.115327,-0.992045
1441,0,0,0,0,1184,26,2651,3463,6114,0.027066,-0.0933303,-0.995267
6050,0,0,0,0,3525,112,9687,5465,15152,0.0567427,-0.119944,-0.991158
1466,0,0,0,0,881,25,2372,3041,5413,0.0211148,-0.107606,-0.993969
5833,0,0,0,0,3828,120,9781,5641,15422,0.021515,-0.15818,-0.987176
1787,0,0,0,0,1248,39,3074,3228,6302,0.0537054,-0.106128,-0.992901
4072,0,0,0,0,2941,86,7099,5117,12216,0.0259644,-0.132623,-0.990826
4091,0,0,0,0,2327,67,6485,4330,10815,0.0417279,-0.120656,-0.991817
4063,0,0,0,0,2827,80,6970,4478,11448,0.0256845,-0.0977868,-0.994876
1558,0,0,0,0,1305,37,2900,3649,6549,-0.00231471,-0.0747027,-0.997203
5837,0,0,0,0,5083,151,11071,5080,16151,-0.00240735,-0.096927,-0.995289
1454,0,0,0,0,1286,36,2776,3056,5832,0.022635,-0.0891796,-0.995758
6450,0,0,0,0,5754,158,12362,6233,18595,-0.0254221,-0.132149,-0.990904
2099,0,0,0,0,1986,52,4137,3338,7475,-0.0227438,-0.105997,-0.994106
1395,0,0,0,0,1446,63,2904,2876,5780,-0.00687894,-0.0593741,-0.998212
1492,0,0,0,0,1467,42,3001,3088,6089,-0.0189491,-0.0607984,-0.99797
6036,0,0,0,0,5586,143,11765,4776,16541,-0.00882168,-0.094225,-0.995512
1626,0,0,0,0,1964,57,3647,3178,6825,0.00233408,-0.0459389,-0.998942
1511,0,0,0,0,1790,48,3349,3296,6645,-0.00482478,-0.0536984,-0.998546
1885,0,0,0,0,2219,59,4163,4121,8284,-0.00957733,-0.065619,-0.997799
2256,0,0,0,0,2931,83,5270,4936,10206,-0.000502192,-0.0686942,-0.997638
6042,0,0,0,0,7059,162,13263,4914,18177,-0.0263151,-0.0783461,-0.996579
1639,0,0,0,0,1776,53,3468,2934,6402,-0.00748606,-0.0668086,-0.997738
5977,0,0,0,0,7895,160,14032,5900,19932,0.00561473,-0.115117,-0.993336
1940,0,0,0,0,1830,45,3815,4590,8405,-0.00097204,-0.0757508,-0.997126
1518,0,0,0,0,1701,52,3271,4928,8199,-0.0509225,-0.137845,-0.989144
1891,0,0,0,0,1753,51,3695,4716,8411,0.26679,-0.147794,-0.952355
2056,0,0,0,0,1758,51,3865,7220,11085,0.484981,-0.149577,-0.861638
5905,0,0,0,0,4323,105,10333,-1,-1,-1,-1,-1
1368,0,0,0,0,933,27,2328,3132,5460,-0.0312848,-0.0281474,-0.999114
1402,0,0,0,0,920,30,2352,3243,5595,-0.00572807,-0.0103385,-0.99993
5152,0,0,0,0,2392,72,7616,4313,11929,-0.0486294,-0.111139,-0.992614
1521,0,0,0,0,862,25,2408,3003,5411,-0.0297308,-0.0787977,-0.996447
1298,0,0,0,0,683,23,2004,3047,5051,-0.0240509,-0.055147,-0.998189
5769,0,0,0,0,2674,88,8531,5816,14347,-0.0393428,-0.0801599,-0.996005
1663,0,0,0,0,827,25,2515,3239,5754,-0.0474322,-0.0598928,-0.997077
1279,0,0,0,0,544,17,1840,3445,5285,-0.0531947,-0.0628576,-0.996604
6080,0,0,0,0,2342,88,8510,5327,13837,-0.0758097,-0.126668,-0.989044
1694,0,0,0,0,635,24,2353,3490,5843,-0.101796,-0.154202,-0.982781
1300,0,0,0,0,423,14,1737,3016,4753,-0.0559172,-0.0586522,-0.996711
1420,0,0,0,0,512,16,1948,3637,5585,-0.0671944,-0.10218,-0.992494
1733,0,0,0,0,565,18,2316,4648,6964,-0.0451312,-0.0842909,-0.995419
2198,0,0,0,0,688,24,2910,5827,8737,-0.043683,-0.101629,-0.993863
5545,0,0,0,0,1552,57,7154,5817,12971,-0.062134,-0.107988,-0.992209
1430,0,0,0,0,478,16,1924,3225,5149,-0.0108973,-0.0710259,-0.997415
1603,0,0,0,0,477,44,2124,3561,5685,-0.0211184,-0.0592657,-0.998019
5402,0,0,0,0,1491,57,6950,5278,12228,-0.0148254,-0.11558,-0.993188
1649,0,0,0,0,425,17,2091,3185,5276,-0.000716605,-0.0806803,-0.99674
1311,0,0,0,0,299,14,1624,3312,4936,0.00034605,-0.0903753,-0.995908
1642,0,0,0,0,383,18,2043,4313,6356,-0.0144727,-0.0755144,-0.99704
2481,0,0,0,0,591,26,3098,6864,9962,-0.0429486,-0.104016,-0.993648
2468,0,0,0,0,869,29,3366,5318,8684,-0.027062,-0.117736,-0.992676
1535,0,0,0,0,374,15,1924,3818,5742,-0.0319507,-0.114944,-0.992858
1695,0,0,0,0,508,19,2222,4295,6517,-0.0238973,-0.119661,-0.992527
2218,0,0,0,0,627,25,2870,5467,8337,-0.0187116,-0.136352,-0.990484
2533,0,0,0,0,774,27,3334,5858,9192,0.00651486,-0.146383,-0.989207
1911,0,0,0,0,704,33,2648,4481,7129,0.00025606,-0.152203,-0.988349
2088,0,0,0,0,863,26,2977,5855,8832,0.0199441,-0.155264,-0.987672
2587,0,0,0,0,968,32,3587,6345,9932,0.00230567,-0.139153,-0.990268
1712,0,0,0,0,718,22,2452,4372,6824,-0.000945507,-0.135531,-0.990773
5404,0,0,0,0,2520,88,8012,5620,13632,-0.028953,-0.212309,-0.976774
1479,0,0,0,0,760,20,2259,4669,6928,-0.0131827,-0.208585,-0.977915
1515,0,0,0,0,833,25,2373,4821,7194,-0.0300114,-0.238217,-0.970748
2099,0,0,0,0,1249,38,3386,8208,11594,-0.096714,-0.3101,-0.945772
6090,0,0,0,0,4681,150,10921,7333,18254,-0.271642,0.151794,-0.950352
1844,0,0,0,0,1472,44,3360,3844,7204,-0.156826,0.108717,-0.981624
1473,0,0,0,0,1227,36,2736,3140,5876,0.00662861,-0.160868,-0.986954
1886,0,0,0,0,1873,58,3817,9493,13310,0.139542,-0.12317,-0.982526
1951,0,0,0,0,2021,65,4037,4960,8997,0.122446,-0.159888,-0.979511
2554,0,0,0,0,2535,70,5159,5583,10742,0.124623,-0.216291,-0.968343
2243,0,0,0,0,1827,51,4121,10388,14509,0.200651,-0.228489,-0.952645
1421,0,0,0,0,1370,41,2832,5588,8420,0.15326,-0.242125,-0.958064
1614,0,0,0,0,1367,39,3020,4566,7586,-0.00815295,-0.18345,-0.982995
1662,0,0,0,0,1343,38,3043,3784,6827,0.0278072,-0.180204,-0.983236
5718,0,0,0,0,2995,83,8796,4381,13177,0.0401755,-0.188062,-0.981335
1625,0,0,0,0,979,33,2637,3570,6207,0.0331798,-0.169932,-0.984897
5972,0,0,0,0,3052,102,9126,5305,14431,0.0571192,-0.195273,-0.979084
1903,0,0,0,0,894,31,2828,3200,6028,0.0695488,-0.155989,-0.985307
1461,0,0,0,0,783,24,2268,3258,5526,0.0353907,-0.15613,-0.987102
6370,0,0,0,0,2657,82,9109,5039,14148,0.0405598,-0.165695,-0.985343
1580,0,0,0,0,566,21,2167,3657,5824,0.0446869,-0.118172,-0.991987
1571,0,0,0,0,543,19,2133,3441,5574,0.0181015,-0.124224,-0.992089
5945,0,0,0,0,1839,63,7847,5910,13757,0.0349546,-0.159937,-0.986508
1582,0,0,0,0,437,18,2037,3082,5119,0.0292845,-0.120946,-0.992227
6074,0,0,0,0,1727,71,7872,5941,13813,0.0519519,-0.20193,-0.978021
1688,0,0,0,0,456,16,2160,3349,5509,0.0437453,-0.1697,-0.984524
1309,0,0,0,0,343,11,1663,2871,4534,0.047878,-0.1291,-0.990475
1325,0,0,0,0,426,15,1766,3342,5108,0.0461902,-0.120097,-0.991687
2096,0,0,0,0,747,24,2867,4950,7817,0.039546,-0.12849,-0.990922
3423,0,0,0,0,1315,46,4784,7977,12761,0.031182,-0.149154,-0.988322
2091,0,0,0,0,844,28,2963,4778,7741,0.0500529,-0.106387,-0.993064
6620,0,0,0,0,3123,99,9842,5799,15641,0.0136843,-0.194637,-0.98078
2337,0,0,0,0,696,22,3055,3476,6531,0.0183777,-0.141831,-0.98972
1285,0,0,0,0,542,17,1844,3167,5011,0.0432172,-0.101928,-0.993853
1545,0,0,0,0,526,18,2089,3297,5386,0.0119239,-0.124893,-0.992099
1834,0,0,0,0,682,22,2538,4888,7426,0.0480953,-0.121475,-0.991429
1964,0,0,0,0,775,25,2764,5302,8066,0.0309759,-0.0978967,-0.994714
6093,0,0,0,0,2523,85,8701,5362,14063,-0.0157815,-0.20035,-0.979597
1678,0,0,0,0,761,22,2461,3318,5779,0.00852507,-0.125297,-0.992083
1228,0,0,0,0,542,18,1788,3045,4833,0.00734,-0.125881,-0.992018
1257,0,0,0,0,657,27,1941,3218,5159,0.00503854,-0.0864995,-0.996239
1988,0,0,0,0,851,28,2867,5473,8340,0.00635926,-0.0940703,-0.995545
3212,0,0,0,0,1358,45,4615,6784,11399,-0.0122517,-0.0967982,-0.995229
2021,0,0,0,0,931,32,2984,5072,8056,0.00458239,-0.0235453,-0.999712
1970,0,0,0,0,873,27,2870,4970,7840,0.0167957,-0.0695005,-0.997441
2596,0,0,0,0,1208,38,3842,5956,9798,0.0302268,-0.0812965,-0.996232
1901,0,0,0,0,848,27,2776,4398,7174,0.019841,-0.0940285,-0.995372
2432,0,0,0,0,1132,37,3601,5640,9241,0.0172949,-0.111874,-0.993572
1973,0,0,0,0,994,31,2998,4871,7869,0.0162165,-0.104922,-0.994348
2532,0,0,0,0,1148,42,3722,5390,9112,0.0267375,-0.130163,-0.991132
6410,0,0,0,0,3378,116,9904,5619,15523,0.0121361,-0.179982,-0.983595
1761,0,0,0,0,938,28,2727,3292,6019,0.01882,-0.148788,-0.98869
1216,0,0,0,0,707,21,1944,3092,5036,0.029611,-0.107742,-0.993738
1273,0,0,0,0,773,23,2069,2952,5021,0.0194844,-0.080371,-0.996575
1924,0,0,0,0,1188,37,3149,4470,7619,0.00954506,-0.0947157,-0.995459
2492,0,0,0,0,1572,55,4119,5869,9988,0.00987011,-0.0958555,-0.995346
2078,0,0,0,0,1912,52,4042,4855,8897,0.0179936,-0.114452,-0.993266
2212,0,0,0,0,1188,40,3440,4286,7726,0.0167914,-0.0951697,-0.995319
5745,0,0,0,0,4588,138,10471,5259,15730,0.0284137,-0.114964,-0.992963
1393,0,0,0,0,982,33,2408,2840,5248,0.0208074,-0.0862917,-0.996053
2100,0,0,0,0,1219,38,3357,4140,7497,0.0108302,-0.100194,-0.994909
2642,0,0,0,0,2155,63,4860,6021,10881,0.0324246,-0.0978331,-0.994674
2240,0,0,0,0,1787,50,4077,5075,9152,0.014082,-0.0952633,-0.995353
2190,0,0,0,0,1911,53,4154,4703,8857,0.00839061,-0.103128,-0.994633
2183,0,0,0,0,1958,54,4195,4839,9034,-0.00711377,-0.10136,-0.994824
6096,0,0,0,0,5171,154,11421,5354,16775,-0.00764905,-0.0983917,-0.995118
1553,0,0,0,0,1176,33,2762,2906,5668,0.00944808,-0.076339,-0.997037
1652,0,0,0,0,1271,36,2959,3655,6614,-0.00182408,-0.0899783,-0.995942
2232,0,0,0,0,1694,52,3978,5099,9077,0.0143237,-0.069367,-0.997488
3044,0,0,0,0,2124,62,5230,6349,11579,-0.0102797,-0.0951679,-0.995408
6180,0,0,0,0,4647,145,10972,5215,16187,0.0104578,-0.165072,-0.986226
1804,0,0,0,0,1118,39,2961,3090,6051,0.0181096,-0.104336,-0.994377
1194,0,0,0,0,714,20,1928,2919,4847,-0.0159014,-0.0805557,-0.996623
1264,0,0,0,0,703,24,1991,3010,5001,-0.0134312,-0.0437711,-0.998951
2145,0,0,0,0,860,28,3033,3848,6881,-0.018305,-0.0428501,-0.998914
1821,0,0,0,0,910,28,2759,4300,7059,0.00421288,-0.0238058,-0.999708
2459,0,0,0,0,1364,41,3864,6602,10466,-0.0151357,-0.0265566,-0.999533
6219,0,0,0,0,3232,109,9560,5486,15046,-0.0437994,0.0441501,-0.998064
1715,0,0,0,0,910,28,2653,3217,5870,-0.0311375,0.0473037,-0.998395
5213,0,0,0,0,2163,66,7442,4403,11845,-0.0275289,0.0533513,-0.998196
1321,0,0,0,0,797,24,2142,2853,4995,-0.030601,0.0574962,-0.997877
1807,0,0,0,0,1180,34,3021,4789,7810,-0.0272424,0.0858279,-0.995937
3261,0,0,0,0,1651,49,4961,5254,10215,-0.022955,0.0878819,-0.995866
5884,0,0,0,0,5242,151,11277,5898,17175,-0.0247984,0.128638,-0.991381
1728,0,0,0,0,1345,38,3111,3139,6250,-0.0145434,0.103588,-0.994514
1450,0,0,0,0,1061,30,2541,3171,5712,-0.0150539,0.100139,-0.99486
2196,0,0,0,0,1432,41,3669,4180,7849,-0.000528168,0.108063,-0.994144
3239,0,0,0,0,2599,77,5915,6579,12494,0.0185798,0.119801,-0.992624
2271,0,0,0,0,1806,52,4129,4269,8398,0.0125322,0.107239,-0.994154
1978,0,0,0,0,1766,49,3793,4550,8343,0.0218509,0.153465,-0.987912
2128,0,0,0,0,1755,50,3933,4972,8905,0.0368576,0.147775,-0.988334
